id_unidad;blanco_y_nulo;PLN;PSD;votos;habilitados
00-1-01-01-0001;7;128;93;228;423
00-1-01-01-0002;6;155;79;240;423
00-1-01-01-0003;5;130;89;224;424
00-1-01-01-0004;11;202;126;339;547
00-1-01-01-0005;12;195;117;324;547
00-1-01-01-0007;8;201;113;322;547
00-1-01-01-0008;9;189;124;322;547
00-1-01-01-0009;8;211;119;338;547
00-1-01-01-0010;9;207;112;328;548
00-1-01-02-0011;7;144;131;282;565
00-1-01-02-0012;7;145;160;312;565
00-1-01-02-0013;9;124;154;287;565
00-1-01-02-0014;9;146;140;295;565
00-1-01-02-0015;3;125;146;274;565
00-1-01-02-0016;3;132;151;286;565
00-1-01-02-0017;5;132;158;295;565
00-1-01-02-0018;7;141;124;272;565
00-1-01-02-0020;9;121;143;273;565
00-1-01-02-0021;2;140;126;268;565
00-1-01-02-0022;7;163;153;323;565
00-1-01-02-0023;6;130;141;277;565
00-1-01-02-0024;12;135;154;301;565
00-1-01-02-0025;7;146;140;293;565
00-1-01-02-0026;8;173;151;332;532
00-1-01-02-0027;11;160;142;313;532
00-1-01-02-0028;14;140;143;297;533
00-1-01-03-0029;0;136;120;256;551
00-1-01-03-0030;4;118;121;243;551
00-1-01-03-0031;3;99;118;220;552
00-1-01-03-0032;10;156;144;310;542
00-1-01-03-0033;4;163;150;317;542
00-1-01-03-0034;7;140;155;302;542
00-1-01-03-0035;13;131;151;295;542
00-1-01-03-0036;8;156;128;292;542
00-1-01-03-0037;8;127;162;297;542
00-1-01-03-0038;5;138;124;267;542
00-1-01-03-0039;11;124;149;284;545
00-1-01-03-0040;8;141;144;293;573
00-1-01-03-0041;5;135;169;309;573
00-1-01-03-0042;5;158;143;306;573
00-1-01-03-0043;2;142;168;312;573
00-1-01-03-0044;7;150;155;312;573
00-1-01-03-0045;8;172;157;337;573
00-1-01-03-0046;7;124;163;294;573
00-1-01-03-0047;4;177;148;329;573
00-1-01-03-0048;10;145;146;301;573
00-1-01-03-0049;7;147;135;289;573
00-1-01-03-0050;7;135;157;299;573
00-1-01-03-0051;8;152;172;332;573
00-1-01-03-0052;3;147;161;311;573
00-1-01-03-0053;5;170;145;320;573
00-1-01-03-0054;9;150;151;310;573
00-1-01-03-0055;3;138;140;281;588
00-1-01-03-0056;11;184;144;339;543
00-1-01-03-0057;3;196;139;338;543
00-1-01-03-0058;21;200;123;344;543
00-1-01-03-0059;12;171;134;317;543
00-1-01-03-0060;9;191;146;346;545
00-1-01-03-0061;0;15;6;21;252
00-1-01-04-0062;3;114;133;250;520
00-1-01-04-0063;6;136;108;250;520
00-1-01-04-0064;3;129;110;242;520
00-1-01-04-0065;7;191;132;330;605
00-1-01-04-0066;4;194;150;348;605
00-1-01-04-0067;9;170;180;359;605
00-1-01-04-0068;8;171;157;336;605
00-1-01-04-0069;13;178;166;357;605
00-1-01-04-0070;11;157;135;303;605
00-1-01-04-0071;5;217;146;368;605
00-1-01-04-0072;7;179;154;340;605
00-1-01-04-0073;12;186;171;369;605
00-1-01-04-0074;11;163;172;346;605
00-1-01-04-0075;10;161;172;343;610
00-1-01-04-0076;5;141;133;279;461
00-1-01-04-0077;6;170;108;284;461
00-1-01-04-0078;13;143;116;272;461
00-1-01-04-0079;9;144;128;281;463
00-1-01-04-0080;10;190;177;377;572
00-1-01-04-0081;13;207;134;354;572
00-1-01-04-0082;9;183;153;345;572
00-1-01-04-0083;13;184;157;354;572
00-1-01-04-0084;12;195;132;339;572
00-1-01-04-0085;10;178;161;349;572
00-1-01-04-0086;4;172;158;334;572
00-1-01-04-0087;9;207;150;366;572
00-1-01-04-0088;14;167;173;354;578
00-1-01-05-0089;11;240;178;429;600
00-1-01-05-0090;10;214;157;381;600
00-1-01-05-0091;15;196;176;387;600
00-1-01-05-0092;24;209;136;369;600
00-1-01-05-0093;16;188;173;377;600
00-1-01-05-0094;7;192;192;391;600
00-1-01-05-0095;4;223;138;365;600
00-1-01-05-0096;9;203;163;375;600
00-1-01-05-0097;9;214;175;398;600
00-1-01-05-0098;9;209;173;391;600
00-1-01-05-0099;6;205;172;383;600
00-1-01-05-0100;9;215;170;394;600
00-1-01-05-0101;16;200;171;387;600
00-1-01-05-0102;6;201;185;392;600
00-1-01-05-0103;5;195;153;353;600
00-1-01-05-0104;9;188;157;354;600
00-1-01-05-0105;14;193;163;370;600
00-1-01-05-0106;9;188;173;370;600
00-1-01-05-0107;9;207;149;365;600
00-1-01-05-0108;10;195;178;383;600
00-1-01-05-0109;8;214;149;371;585
00-1-01-05-0110;5;184;152;341;584
00-1-01-05-0111;11;230;168;409;583
00-1-01-05-0112;16;205;175;396;583
00-1-01-05-0113;18;209;165;392;583
00-1-01-05-0114;16;232;157;405;583
00-1-01-05-0115;11;251;143;405;583
00-1-01-05-0116;5;229;166;400;583
00-1-01-05-0117;11;216;156;383;583
00-1-01-05-0118;20;214;165;399;583
00-1-01-05-0119;11;217;166;394;584
00-1-01-06-0120;9;240;159;408;591
00-1-01-06-0121;10;233;162;405;591
00-1-01-06-0122;15;203;178;396;591
00-1-01-06-0123;7;228;151;386;591
00-1-01-06-0124;10;207;170;387;591
00-1-01-06-0125;14;202;159;375;591
00-1-01-06-0126;4;231;163;398;591
00-1-01-06-0127;10;223;160;393;591
00-1-01-06-0128;19;222;153;394;591
00-1-01-06-0129;10;221;163;394;591
00-1-01-06-0130;14;213;174;401;591
00-1-01-06-0131;13;231;147;391;591
00-1-01-06-0132;10;209;177;396;591
00-1-01-06-0133;10;248;145;403;591
00-1-01-06-0134;11;216;165;392;591
00-1-01-06-0135;7;221;170;398;591
00-1-01-06-0136;11;234;135;380;591
00-1-01-06-0137;12;228;154;394;591
00-1-01-06-0138;14;243;148;405;593
00-1-01-06-0139;18;225;159;402;577
00-1-01-06-0140;7;202;206;415;577
00-1-01-06-0141;7;208;169;384;577
00-1-01-06-0142;9;238;146;393;577
00-1-01-06-0143;11;207;164;382;577
00-1-01-06-0144;15;226;130;371;577
00-1-01-06-0145;15;198;161;374;577
00-1-01-06-0146;8;214;165;387;577
00-1-01-06-0147;9;240;143;392;577
00-1-01-06-0148;12;227;169;408;577
00-1-01-06-0149;17;211;169;397;577
00-1-01-06-0150;12;221;152;385;577
00-1-01-07-0151;4;175;137;316;560
00-1-01-07-0152;10;169;162;341;560
00-1-01-07-0153;8;167;144;319;560
00-1-01-07-0154;5;151;139;295;560
00-1-01-07-0155;12;169;127;308;561
00-1-01-07-0156;10;248;142;400;607
00-1-01-07-0157;5;237;173;415;607
00-1-01-07-0158;17;211;140;368;607
00-1-01-07-0159;26;214;177;417;607
00-1-01-07-0160;14;219;167;400;608
00-1-01-07-0161;6;156;124;286;469
00-1-01-07-0162;7;138;142;287;470
00-1-01-07-0163;12;109;164;285;558
00-1-01-07-0164;6;131;164;301;559
00-1-01-07-0165;4;73;156;233;636
00-1-01-07-0166;6;67;139;212;636
00-1-01-07-0167;6;72;160;238;636
00-1-01-07-0168;5;75;156;236;636
00-1-01-07-0169;1;66;172;239;636
00-1-01-07-0170;2;58;151;211;636
00-1-01-07-0171;2;67;116;185;636
00-1-01-07-0172;7;59;148;214;636
00-1-01-07-0173;8;76;134;218;636
00-1-01-07-0174;4;67;154;225;639
00-1-01-07-0175;9;187;171;367;578
00-1-01-07-0176;13;181;185;379;578
00-1-01-07-0177;8;192;185;385;578
00-1-01-07-0178;6;190;166;362;578
00-1-01-07-0179;14;172;179;365;578
00-1-01-07-0180;13;167;180;360;583
00-1-01-07-0181;0;7;6;13;111
00-1-01-08-0182;9;247;116;372;610
00-1-01-08-0183;7;264;120;391;610
00-1-01-08-0184;4;256;128;388;610
00-1-01-08-0185;8;259;112;379;610
00-1-01-08-0186;5;242;135;382;610
00-1-01-08-0187;9;236;110;355;613
00-1-01-08-0188;12;211;151;374;600
00-1-01-08-0189;11;216;165;392;600
00-1-01-08-0190;10;214;158;382;600
00-1-01-08-0191;7;218;164;389;600
00-1-01-08-0192;6;205;165;376;600
00-1-01-08-0193;6;203;141;350;573
00-1-01-08-0194;8;209;121;338;573
00-1-01-09-0195;12;211;146;369;612
00-1-01-09-0196;11;233;154;398;612
00-1-01-09-0197;5;204;132;341;612
00-1-01-09-0198;9;237;163;409;612
00-1-01-09-0199;5;221;140;366;612
00-1-01-09-0200;15;212;165;392;612
00-1-01-09-0201;18;204;139;361;612
00-1-01-09-0202;5;198;155;358;612
00-1-01-09-0203;7;218;140;365;612
00-1-01-09-0204;10;182;162;354;612
00-1-01-09-0205;7;231;145;383;612
00-1-01-09-0206;8;233;143;384;612
00-1-01-09-0207;4;201;176;381;612
00-1-01-09-0208;7;236;137;380;612
00-1-01-09-0209;8;199;140;347;612
00-1-01-09-0210;10;217;168;395;612
00-1-01-09-0211;10;207;144;361;612
00-1-01-09-0212;7;209;153;369;612
00-1-01-09-0214;7;212;145;364;612
00-1-01-09-0215;14;217;157;388;612
00-1-01-09-0216;7;207;129;343;612
00-1-01-09-0217;7;232;162;401;612
00-1-01-09-0218;8;201;126;335;618
00-1-01-09-0219;7;99;186;292;600
00-1-01-09-0220;0;112;173;285;600
00-1-01-09-0221;5;119;188;312;600
00-1-01-09-0222;15;118;153;286;600
00-1-01-09-0223;8;109;166;283;600
00-1-01-09-0224;7;106;172;285;600
00-1-01-09-0225;9;136;160;305;600
00-1-01-09-0226;6;118;161;285;600
00-1-01-09-0227;5;128;168;301;600
00-1-01-09-0228;8;119;178;305;600
00-1-01-09-0229;5;101;166;272;600
00-1-01-09-0230;8;113;156;277;600
00-1-01-09-0231;5;97;156;258;600
00-1-01-09-0232;6;102;175;283;600
00-1-01-09-0233;7;132;175;314;600
00-1-01-09-0234;7;95;179;281;600
00-1-01-09-0235;4;102;150;256;600
00-1-01-09-0236;9;102;163;274;600
00-1-01-09-0237;6;96;169;271;600
00-1-01-09-0238;7;115;179;301;600
00-1-01-09-0239;4;107;182;293;600
00-1-01-09-0241;5;107;176;288;600
00-1-01-09-0242;5;86;146;237;600
00-1-01-09-0243;5;98;161;264;600
00-1-01-09-0244;5;128;161;294;600
00-1-01-09-0245;5;131;150;286;600
00-1-01-09-0246;10;102;169;281;600
00-1-01-09-0247;6;130;169;305;600
00-1-01-09-0248;6;113;163;282;600
00-1-01-09-0249;11;123;164;298;600
00-1-01-09-0250;9;117;159;285;600
00-1-01-09-0251;9;92;164;265;600
00-1-01-09-0252;3;119;163;285;600
00-1-01-09-0253;5;125;180;310;599
00-1-01-09-0254;6;106;153;265;598
00-1-01-09-0255;10;202;165;377;586
00-1-01-09-0256;10;213;169;392;586
00-1-01-09-0257;17;208;176;401;586
00-1-01-09-0258;12;194;170;376;586
00-1-01-09-0259;5;187;188;380;586
00-1-01-09-0260;7;214;173;394;586
00-1-01-09-0261;8;191;161;360;586
00-1-01-09-0262;8;199;179;386;586
00-1-01-09-0263;13;207;191;411;586
00-1-01-09-0264;8;205;185;398;592
00-1-01-09-0265;8;128;214;350;615
00-1-01-09-0266;7;111;176;294;615
00-1-01-09-0267;8;118;193;319;615
00-1-01-09-0268;9;128;161;298;615
00-1-01-09-0269;2;147;177;326;615
00-1-01-09-0270;10;126;177;313;615
00-1-01-09-0271;17;124;152;293;615
00-1-01-09-0272;11;126;172;309;615
00-1-01-09-0273;7;148;204;359;615
00-1-01-09-0274;5;142;183;330;615
00-1-01-09-0275;14;119;189;322;615
00-1-01-09-0278;5;139;199;343;615
00-1-01-09-0279;8;120;186;314;615
00-1-01-09-0280;7;120;211;338;625
00-1-01-10-0281;9;170;198;377;600
00-1-01-10-0283;10;162;184;356;600
00-1-01-10-0284;14;183;173;370;600
00-1-01-10-0285;9;183;168;360;600
00-1-01-10-0286;10;185;159;354;600
00-1-01-10-0287;11;172;176;359;600
00-1-01-10-0288;9;186;169;364;600
00-1-01-10-0289;13;167;194;374;600
00-1-01-10-0290;6;180;170;356;600
00-1-01-10-0291;7;179;175;361;600
00-1-01-10-0292;15;167;163;345;600
00-1-01-10-0293;8;176;160;344;600
00-1-01-10-0294;14;177;173;364;600
00-1-01-10-0295;6;186;168;360;600
00-1-01-10-0296;11;178;169;358;600
00-1-01-10-0297;8;162;157;327;600
00-1-01-10-0298;9;172;198;379;600
00-1-01-10-0299;6;160;185;351;600
00-1-01-10-0300;7;173;174;354;600
00-1-01-10-0301;9;187;173;369;600
00-1-01-10-0302;8;199;166;373;600
00-1-01-10-0303;8;156;184;348;600
00-1-01-10-0304;13;187;185;385;600
00-1-01-10-0305;11;178;170;359;600
00-1-01-10-0306;11;189;172;372;600
00-1-01-10-0307;2;203;172;377;594
00-1-01-10-0308;10;171;186;367;593
00-1-01-10-0309;6;113;154;273;590
00-1-01-10-0310;5;124;151;280;590
00-1-01-10-0311;7;133;147;287;590
00-1-01-10-0312;3;128;135;266;590
00-1-01-10-0313;8;136;122;266;590
00-1-01-10-0314;8;111;149;268;590
00-1-01-10-0315;11;123;124;258;590
00-1-01-10-0316;2;113;143;258;590
00-1-01-10-0317;6;134;132;272;590
00-1-01-10-0318;6;114;137;257;590
00-1-01-10-0319;10;124;166;300;592
00-1-01-10-0320;5;197;168;370;605
00-1-01-10-0321;9;183;160;352;605
00-1-01-10-0322;12;153;178;343;605
00-1-01-10-0323;7;169;175;351;605
00-1-01-10-0324;9;157;171;337;605
00-1-01-10-0325;6;175;174;355;605
00-1-01-10-0326;6;157;186;349;605
00-1-01-10-0327;10;189;159;358;605
00-1-01-10-0328;13;175;155;343;605
00-1-01-10-0329;3;160;174;337;605
00-1-01-10-0330;16;171;173;360;605
00-1-01-10-0331;8;178;159;345;605
00-1-01-10-0332;6;183;175;364;605
00-1-01-10-0333;9;164;174;347;605
00-1-01-10-0334;13;172;162;347;605
00-1-01-10-0335;8;165;142;315;605
00-1-01-10-0336;10;163;183;356;605
00-1-01-10-0337;5;184;177;366;605
00-1-01-10-0338;10;171;166;347;605
00-1-01-10-0339;9;179;157;345;605
00-1-01-10-0340;10;177;181;368;605
00-1-01-10-0341;12;167;165;344;605
00-1-01-10-0342;6;178;174;358;605
00-1-01-10-0343;7;172;161;340;605
00-1-01-10-0344;5;170;180;355;605
00-1-01-10-0345;17;154;151;322;606
00-1-01-10-0346;7;141;143;291;570
00-1-01-10-0347;5;132;171;308;570
00-1-01-10-0348;9;136;157;302;570
00-1-01-10-0349;9;145;159;313;570
00-1-01-10-0350;11;139;181;331;570
00-1-01-10-0351;10;128;169;307;570
00-1-01-10-0352;10;121;163;294;570
00-1-01-10-0353;4;139;187;330;570
00-1-01-10-0354;10;135;165;310;578
00-1-01-11-0355;11;185;173;369;600
00-1-01-11-0356;7;160;182;349;600
00-1-01-11-0357;8;171;167;346;600
00-1-01-11-0358;7;176;188;371;600
00-1-01-11-0359;5;162;207;374;600
00-1-01-11-0360;15;174;165;354;600
00-1-01-11-0361;10;162;164;336;600
00-1-01-11-0362;11;178;170;359;600
00-1-01-11-0363;4;169;172;345;600
00-1-01-11-0364;9;154;186;349;600
00-1-01-11-0365;5;159;195;359;600
00-1-01-11-0366;12;158;166;336;600
00-1-01-11-0368;9;155;173;337;600
00-1-01-11-0369;6;170;187;363;600
00-1-01-11-0370;10;158;172;340;600
00-1-01-11-0371;11;170;183;364;600
00-1-01-11-0372;14;172;169;355;571
00-1-01-11-0373;10;157;161;328;570
00-1-01-11-0374;10;191;181;382;611
00-1-01-11-0375;9;185;210;404;611
00-1-01-11-0376;11;177;204;392;611
00-1-01-11-0377;15;161;180;356;611
00-1-01-11-0378;15;180;164;359;611
00-1-01-11-0379;11;178;159;348;611
00-1-01-11-0380;10;187;189;386;611
00-1-01-11-0381;9;157;190;356;611
00-1-01-11-0382;4;186;179;369;611
00-1-01-11-0383;8;187;202;397;611
00-1-01-11-0384;10;165;173;348;611
00-1-01-11-0385;10;180;174;364;611
00-1-01-11-0386;15;175;176;366;611
00-1-01-11-0387;8;179;173;360;611
00-1-01-11-0388;4;161;196;361;611
00-1-01-11-0389;11;164;173;348;620
00-1-01-11-0390;9;191;156;356;605
00-1-01-11-0391;6;191;161;358;605
00-1-01-11-0392;9;164;165;338;605
00-1-01-11-0393;10;180;157;347;605
00-1-01-11-0394;9;151;177;337;605
00-1-01-11-0395;9;176;180;365;605
00-1-01-11-0396;4;189;155;348;605
00-1-01-11-0397;11;186;169;366;605
00-1-01-11-0398;14;196;161;371;605
00-1-01-11-0399;4;180;172;356;605
00-1-01-11-0400;8;172;163;343;611
00-1-01-11-0401;13;193;178;384;611
00-1-01-11-0402;7;178;170;355;611
00-1-01-11-0403;7;165;187;359;611
00-1-01-11-0404;6;198;166;370;611
00-1-01-11-0405;6;189;199;394;611
00-1-02-01-0406;10;197;174;381;601
00-1-02-01-0407;10;205;173;388;601
00-1-02-01-0408;6;217;170;393;601
00-1-02-01-0409;9;224;152;385;601
00-1-02-01-0410;10;211;169;390;601
00-1-02-01-0411;19;212;168;399;601
00-1-02-01-0412;11;224;158;393;601
00-1-02-01-0413;8;220;164;392;601
00-1-02-01-0414;15;225;147;387;601
00-1-02-01-0415;7;211;172;390;601
00-1-02-01-0416;9;209;172;390;601
00-1-02-01-0417;9;190;187;386;601
00-1-02-01-0418;5;186;214;405;601
00-1-02-01-0419;11;174;176;361;601
00-1-02-01-0420;12;191;170;373;601
00-1-02-01-0421;20;213;180;413;601
00-1-02-01-0422;5;206;162;373;601
00-1-02-01-0423;12;188;195;395;601
00-1-02-01-0424;8;214;182;404;601
00-1-02-01-0425;11;251;140;402;601
00-1-02-01-0426;8;236;148;392;606
00-1-02-02-0427;11;165;200;376;614
00-1-02-02-0428;12;195;178;385;614
00-1-02-02-0429;11;174;199;384;614
00-1-02-02-0430;10;183;173;366;614
00-1-02-02-0431;8;171;211;390;614
00-1-02-02-0432;13;175;211;399;614
00-1-02-02-0433;10;185;172;367;614
00-1-02-02-0434;15;183;197;395;614
00-1-02-02-0435;10;174;201;385;614
00-1-02-02-0436;10;182;174;366;614
00-1-02-02-0437;10;179;184;373;614
00-1-02-02-0438;6;187;164;357;614
00-1-02-02-0439;10;178;175;363;614
00-1-02-02-0440;17;176;201;394;614
00-1-02-02-0441;9;178;182;369;614
00-1-02-02-0442;10;211;169;390;614
00-1-02-02-0443;10;195;172;377;614
00-1-02-02-0444;11;201;191;403;614
00-1-02-02-0445;11;149;214;374;614
00-1-02-02-0446;13;197;188;398;614
00-1-02-02-0447;9;197;195;401;633
00-1-02-02-0448;6;92;94;192;342
00-1-02-02-0449;5;71;113;189;342
00-1-02-02-0450;16;180;163;359;600
00-1-02-02-0451;13;157;184;354;600
00-1-02-02-0452;4;155;169;328;600
00-1-02-02-0453;12;161;182;355;600
00-1-02-02-0454;13;174;171;358;602
00-1-02-03-0455;6;281;138;425;620
00-1-02-03-0456;6;289;109;404;620
00-1-02-03-0457;13;270;126;409;620
00-1-02-03-0458;9;278;118;405;620
00-1-02-03-0459;11;314;94;419;620
00-1-02-03-0460;10;309;111;430;620
00-1-02-03-0461;8;266;121;395;620
00-1-02-03-0462;12;292;112;416;620
00-1-02-03-0463;4;274;97;375;620
00-1-02-03-0464;5;283;127;415;620
00-1-02-03-0465;7;306;114;427;620
00-1-02-03-0466;4;279;109;392;620
00-1-02-03-0467;3;309;91;403;620
00-1-02-03-0468;15;273;138;426;620
00-1-02-03-0469;13;287;91;391;620
00-1-02-03-0470;7;299;111;417;628
00-1-02-03-0471;11;311;127;449;618
00-1-02-03-0472;10;302;138;450;618
00-1-02-03-0473;11;291;125;427;618
00-1-02-03-0474;7;282;121;410;618
00-1-02-03-0475;12;289;140;441;618
00-1-02-03-0476;8;262;123;393;618
00-1-02-03-0477;10;280;136;426;618
00-1-02-03-0478;8;310;108;426;618
00-1-02-03-0479;12;295;138;445;618
00-1-02-03-0480;9;266;150;425;618
00-1-02-03-0481;7;305;127;439;628
00-1-02-03-0482;16;203;140;359;556
00-1-02-03-0483;6;215;145;366;556
00-1-02-03-0484;10;210;136;356;556
00-1-02-03-0485;7;230;124;361;556
00-1-02-03-0486;7;192;156;355;556
00-1-02-03-0487;6;226;136;368;556
00-1-02-03-0488;14;204;128;346;556
00-1-02-03-0489;9;197;156;362;558
00-1-02-03-0490;1;18;7;26;31
00-1-03-01-0491;8;225;191;424;601
00-1-03-01-0492;10;215;163;388;601
00-1-03-01-0493;5;214;158;377;601
00-1-03-01-0494;7;208;189;404;601
00-1-03-01-0495;12;204;185;401;601
00-1-03-01-0496;13;216;174;403;601
00-1-03-01-0497;9;224;180;413;601
00-1-03-01-0498;7;210;187;404;601
00-1-03-01-0499;12;232;164;408;601
00-1-03-01-0500;9;213;196;418;601
00-1-03-01-0501;6;206;177;389;601
00-1-03-01-0502;8;192;186;386;601
00-1-03-01-0503;3;220;203;426;601
00-1-03-01-0504;16;186;190;392;601
00-1-03-01-0505;15;211;169;395;601
00-1-03-01-0506;12;203;161;376;616
00-1-03-01-0507;10;162;179;351;605
00-1-03-01-0508;10;171;172;353;605
00-1-03-01-0509;9;161;172;342;605
00-1-03-01-0510;13;170;176;359;605
00-1-03-01-0511;14;173;172;359;605
00-1-03-01-0512;13;176;172;361;605
00-1-03-01-0513;11;191;157;359;605
00-1-03-01-0514;11;172;156;339;605
00-1-03-01-0515;11;185;190;386;605
00-1-03-01-0516;8;178;150;336;605
00-1-03-01-0517;3;177;161;341;605
00-1-03-01-0518;6;172;151;329;605
00-1-03-01-0519;9;162;172;343;605
00-1-03-01-0520;9;185;168;362;605
00-1-03-01-0521;6;187;173;366;605
00-1-03-01-0522;11;150;192;353;605
00-1-03-01-0523;9;136;198;343;605
00-1-03-01-0524;2;151;195;348;605
00-1-03-01-0525;8;160;212;380;605
00-1-03-01-0526;10;176;175;361;605
00-1-03-01-0527;11;186;171;368;605
00-1-03-01-0528;9;161;177;347;605
00-1-03-01-0529;14;180;162;356;605
00-1-03-01-0530;13;162;185;360;606
00-1-03-01-0531;4;190;173;367;600
00-1-03-01-0532;8;170;170;348;600
00-1-03-01-0533;9;150;178;337;600
00-1-03-01-0534;12;175;195;382;600
00-1-03-01-0535;12;173;162;347;600
00-1-03-01-0536;12;137;188;337;600
00-1-03-01-0537;11;163;205;379;600
00-1-03-01-0538;5;170;200;375;600
00-1-03-01-0539;12;169;177;358;600
00-1-03-01-0540;9;187;154;350;578
00-1-03-01-0542;1;14;21;36;69
00-1-03-02-0543;4;152;169;325;615
00-1-03-02-0544;5;128;183;316;615
00-1-03-02-0545;7;174;176;357;615
00-1-03-02-0546;8;161;198;367;615
00-1-03-02-0547;7;164;174;345;615
00-1-03-02-0548;7;173;169;349;615
00-1-03-02-0549;6;142;180;328;615
00-1-03-02-0550;8;154;172;334;615
00-1-03-02-0551;8;169;164;341;615
00-1-03-02-0552;11;168;166;345;615
00-1-03-02-0553;12;172;172;356;615
00-1-03-02-0555;5;169;168;342;615
00-1-03-02-0556;6;138;183;327;615
00-1-03-02-0557;7;154;181;342;616
00-1-03-02-0558;6;186;130;322;513
00-1-03-02-0559;10;191;147;348;514
00-1-03-02-0560;8;149;178;335;610
00-1-03-02-0561;11;190;147;348;610
00-1-03-02-0562;13;159;200;372;610
00-1-03-02-0563;10;162;180;352;610
00-1-03-02-0564;6;185;183;374;610
00-1-03-02-0565;6;172;190;368;610
00-1-03-02-0566;9;181;180;370;610
00-1-03-02-0567;11;134;175;320;610
00-1-03-02-0568;2;170;191;363;610
00-1-03-02-0569;10;179;171;360;610
00-1-03-02-0570;10;173;166;349;610
00-1-03-02-0571;11;160;175;346;610
00-1-03-02-0572;5;140;202;347;610
00-1-03-02-0573;9;166;186;361;610
00-1-03-02-0574;9;181;185;375;610
00-1-03-02-0575;10;153;182;345;610
00-1-03-02-0576;2;61;12;75;92
00-1-03-02-0577;11;166;174;351;600
00-1-03-02-0578;10;179;169;358;600
00-1-03-02-0579;2;182;166;350;600
00-1-03-02-0580;6;199;164;369;600
00-1-03-02-0581;4;166;161;331;573
00-1-03-02-0582;8;164;152;324;572
00-1-03-02-0583;2;44;72;118;181
00-1-03-02-0584;4;96;136;236;481
00-1-03-02-0585;10;107;133;250;481
00-1-03-02-0586;10;157;159;326;571
00-1-03-02-0587;14;139;175;328;571
00-1-03-02-0588;9;141;151;301;571
00-1-03-02-0589;8;149;183;340;571
00-1-03-02-0590;8;130;150;288;571
00-1-03-02-0591;6;142;141;289;571
00-1-03-02-0592;8;120;171;299;571
00-1-03-02-0593;7;130;153;290;571
00-1-03-02-0594;14;126;179;319;576
00-1-03-03-0595;7;142;186;335;593
00-1-03-03-0596;6;171;177;354;593
00-1-03-03-0597;10;132;165;307;593
00-1-03-03-0598;8;134;161;303;593
00-1-03-03-0599;7;150;184;341;593
00-1-03-03-0600;11;162;181;354;593
00-1-03-03-0601;5;152;156;313;593
00-1-03-03-0602;3;173;138;314;593
00-1-03-03-0603;4;155;163;322;593
00-1-03-03-0604;5;156;161;322;593
00-1-03-03-0605;7;143;176;326;593
00-1-03-03-0606;9;133;180;322;593
00-1-03-03-0607;6;143;167;316;593
00-1-03-03-0608;8;145;173;326;593
00-1-03-03-0609;5;155;151;311;593
00-1-03-03-0610;9;128;182;319;593
00-1-03-03-0611;13;158;149;320;593
00-1-03-03-0612;9;167;163;339;593
00-1-03-03-0613;10;140;178;328;593
00-1-03-03-0614;11;144;178;333;593
00-1-03-03-0615;6;154;156;316;593
00-1-03-03-0617;8;185;137;330;605
00-1-03-04-0618;10;181;177;368;610
00-1-03-04-0619;9;176;196;381;610
00-1-03-04-0620;17;184;159;360;610
00-1-03-04-0621;6;165;181;352;610
00-1-03-04-0622;12;196;192;400;610
00-1-03-04-0623;6;196;175;377;610
00-1-03-04-0624;5;205;185;395;610
00-1-03-04-0625;6;177;187;370;610
00-1-03-04-0626;7;169;187;363;610
00-1-03-04-0627;11;170;168;349;610
00-1-03-04-0628;8;208;185;401;610
00-1-03-04-0629;12;234;141;387;610
00-1-03-04-0630;10;180;161;351;610
00-1-03-04-0631;8;187;174;369;610
00-1-03-04-0632;6;190;180;376;610
00-1-03-04-0633;3;178;195;376;610
00-1-03-04-0634;3;185;186;374;610
00-1-03-04-0635;5;180;180;365;610
00-1-03-04-0636;8;185;173;366;623
00-1-03-04-0637;0;38;24;62;242
00-1-03-04-0638;1;5;2;8;35
00-1-03-04-0639;0;5;7;12;30
00-1-03-05-0640;9;235;166;410;591
00-1-03-05-0641;10;239;151;400;591
00-1-03-05-0642;17;220;168;405;591
00-1-03-05-0643;11;214;180;405;591
00-1-03-05-0644;14;225;173;412;591
00-1-03-05-0645;11;242;144;397;591
00-1-03-05-0646;8;193;198;399;591
00-1-03-05-0647;10;202;174;386;591
00-1-03-05-0648;4;200;182;386;591
00-1-03-05-0649;9;224;179;412;591
00-1-03-05-0650;14;198;166;378;591
00-1-03-05-0652;8;202;172;382;591
00-1-03-05-0653;7;212;189;408;591
00-1-03-05-0654;9;219;157;385;591
00-1-03-05-0655;12;222;159;393;602
00-1-03-06-0656;9;193;109;311;488
00-1-03-06-0657;11;215;92;318;488
00-1-03-06-0658;9;244;97;350;488
00-1-03-06-0659;11;218;108;337;488
00-1-03-06-0660;5;200;89;294;461
00-1-03-06-0661;5;220;102;327;462
00-1-03-06-0662;1;86;56;143;218
00-1-03-07-0663;11;201;159;371;600
00-1-03-07-0664;15;193;167;375;600
00-1-03-07-0665;13;199;175;387;600
00-1-03-07-0666;9;199;171;379;600
00-1-03-07-0667;10;160;196;366;596
00-1-03-07-0668;7;168;176;351;595
00-1-03-07-0669;11;121;170;302;553
00-1-03-07-0670;7;124;165;296;553
00-1-03-07-0671;8;131;158;297;553
00-1-03-07-0672;7;152;137;296;553
00-1-03-07-0673;6;133;158;297;553
00-1-03-07-0675;3;119;160;282;556
00-1-03-08-0676;12;226;96;334;461
00-1-03-08-0677;7;256;105;368;462
00-1-03-08-0678;10;245;85;340;457
00-1-03-08-0679;10;217;96;323;458
00-1-03-08-0680;3;341;63;407;529
00-1-03-08-0681;7;300;90;397;529
00-1-03-08-0682;14;209;103;326;467
00-1-03-09-0683;7;188;138;333;537
00-1-03-09-0684;9;197;135;341;537
00-1-03-09-0685;8;193;107;308;538
00-1-03-09-0686;2;135;55;192;340
00-1-03-09-0687;1;66;24;91;173
00-1-03-09-0688;4;123;115;242;369
00-1-03-09-0689;6;129;98;233;370
00-1-03-09-0690;5;84;20;109;148
00-1-03-09-0691;7;126;36;169;232
00-1-03-10-0692;16;161;188;365;541
00-1-03-10-0693;17;193;174;384;541
00-1-03-10-0694;8;184;179;371;541
00-1-03-10-0695;4;182;176;362;541
00-1-03-10-0696;7;178;182;367;541
00-1-03-10-0697;15;159;205;379;607
00-1-03-10-0698;8;165;201;374;607
00-1-03-10-0699;9;181;176;366;607
00-1-03-10-0700;12;185;190;387;607
00-1-03-10-0701;8;169;184;361;607
00-1-03-10-0702;12;139;186;337;607
00-1-03-10-0703;6;154;190;350;607
00-1-03-10-0704;14;176;194;384;607
00-1-03-10-0705;6;136;188;330;607
00-1-03-10-0706;10;167;200;377;607
00-1-03-10-0707;9;187;181;377;610
00-1-03-11-0708;6;168;174;348;589
00-1-03-11-0709;9;149;182;340;589
00-1-03-11-0710;7;149;204;360;589
00-1-03-11-0711;10;187;154;351;589
00-1-03-11-0712;10;159;189;358;589
00-1-03-11-0713;6;162;179;347;589
00-1-03-11-0714;9;205;150;364;589
00-1-03-11-0715;11;130;173;314;589
00-1-03-11-0716;8;153;183;344;589
00-1-03-11-0717;10;167;176;353;589
00-1-03-11-0718;5;176;163;344;589
00-1-03-11-0719;9;157;172;338;589
00-1-03-11-0720;11;149;166;326;589
00-1-03-11-0721;10;170;160;340;589
00-1-03-11-0722;4;153;190;347;589
00-1-03-11-0723;6;166;152;324;589
00-1-03-11-0724;11;166;177;354;589
00-1-03-11-0725;11;195;160;366;589
00-1-03-11-0726;6;148;183;337;593
00-1-03-11-0728;8;173;167;348;556
00-1-03-11-0729;8;147;184;339;556
00-1-03-11-0730;8;160;182;350;556
00-1-03-11-0731;12;135;191;338;556
00-1-03-11-0732;7;168;174;349;556
00-1-03-11-0733;12;163;181;356;556
00-1-03-11-0734;4;155;164;323;556
00-1-03-11-0735;4;158;156;318;556
00-1-03-11-0736;9;167;170;346;559
00-1-03-12-0737;15;188;189;392;609
00-1-03-12-0738;8;241;183;432;609
00-1-03-12-0739;14;186;183;383;609
00-1-03-12-0740;13;218;162;393;609
00-1-03-12-0741;9;181;201;391;609
00-1-03-12-0742;13;223;172;408;609
00-1-03-12-0743;11;191;182;384;609
00-1-03-12-0744;10;189;165;364;609
00-1-03-12-0745;10;189;178;377;609
00-1-03-12-0746;10;201;161;372;609
00-1-03-12-0748;14;226;189;429;610
00-1-03-12-0749;4;221;165;390;575
00-1-03-12-0750;9;181;196;386;575
00-1-03-12-0751;11;162;190;363;575
00-1-03-12-0752;15;180;200;395;575
00-1-03-12-0753;16;191;173;380;575
00-1-03-12-0754;17;179;184;380;575
00-1-03-12-0755;12;175;185;372;575
00-1-03-12-0756;6;174;171;351;575
00-1-03-12-0757;13;197;168;378;575
00-1-03-12-0758;10;203;197;410;581
00-1-03-13-0759;7;110;187;304;632
00-1-03-13-0760;12;135;149;296;632
00-1-03-13-0761;6;118;150;274;632
00-1-03-13-0762;2;114;164;280;632
00-1-03-13-0763;7;104;158;269;632
00-1-03-13-0764;8;110;163;281;632
00-1-03-13-0765;8;120;152;280;632
00-1-03-13-0766;8;116;153;277;632
00-1-03-13-0767;2;117;141;260;632
00-1-03-13-0768;5;102;178;285;632
00-1-03-13-0769;5;152;153;310;632
00-1-03-13-0770;6;122;149;277;632
00-1-03-13-0771;5;104;172;281;632
00-1-03-13-0772;1;120;153;274;632
00-1-03-13-0773;5;108;174;287;632
00-1-03-13-0774;4;123;146;273;632
00-1-03-13-0775;4;109;148;261;632
00-1-03-13-0777;5;111;190;306;632
00-1-03-13-0778;7;110;139;256;632
00-1-03-13-0779;13;135;159;307;632
00-1-03-13-0780;8;114;135;257;642
00-1-04-01-0781;8;188;192;388;601
00-1-04-01-0782;5;219;181;405;601
00-1-04-01-0783;7;191;182;380;601
00-1-04-01-0784;7;197;182;386;601
00-1-04-01-0785;10;202;174;386;601
00-1-04-01-0786;14;207;170;391;601
00-1-04-01-0787;3;206;176;385;601
00-1-04-01-0788;3;202;185;390;601
00-1-04-01-0789;9;214;170;393;601
00-1-04-01-0790;7;196;191;394;601
00-1-04-01-0791;9;192;188;389;601
00-1-04-01-0792;8;189;192;389;601
00-1-04-01-0793;3;194;200;397;601
00-1-04-01-0794;11;164;223;398;602
00-1-04-01-0795;3;127;131;261;468
00-1-04-01-0796;5;113;128;246;469
00-1-04-01-0797;4;140;132;276;392
00-1-04-01-0799;2;13;12;27;74
00-1-04-01-0800;3;12;10;25;38
00-1-04-01-0801;5;134;103;242;343
00-1-04-01-0802;8;140;105;253;344
00-1-04-02-0803;9;170;186;365;590
00-1-04-02-0804;8;144;146;298;501
00-1-04-02-0805;3;182;145;330;501
00-1-04-02-0806;8;135;169;312;502
00-1-04-02-0807;1;37;32;70;104
00-1-04-02-0808;2;40;42;84;172
00-1-04-02-0809;0;38;15;53;84
00-1-04-02-0810;5;46;36;87;171
00-1-04-02-0811;0;82;91;173;302
00-1-04-02-0812;0;27;28;55;121
00-1-04-02-0813;2;121;118;241;359
00-1-04-02-0814;4;151;150;305;493
00-1-04-02-0815;10;151;157;318;493
00-1-04-02-0816;5;159;146;310;494
00-1-04-03-0817;7;120;189;316;467
00-1-04-03-0818;11;124;177;312;467
00-1-04-03-0819;15;122;168;305;467
00-1-04-03-0820;9;126;145;280;452
00-1-04-03-0821;10;130;155;295;452
00-1-04-03-0822;9;203;182;394;608
00-1-04-03-0823;6;214;169;389;608
00-1-04-03-0824;10;125;124;259;418
00-1-04-04-0825;8;179;124;311;448
00-1-04-04-0826;6;162;132;300;448
00-1-04-04-0827;0;64;43;107;148
00-1-04-05-0828;9;194;153;356;517
00-1-04-05-0829;9;207;156;372;518
00-1-04-05-0830;6;138;102;246;353
00-1-04-06-0831;6;177;76;259;393
00-1-04-06-0832;11;140;104;255;393
00-1-04-06-0833;6;138;109;253;352
00-1-04-06-0834;2;134;115;251;353
00-1-04-07-0835;5;91;101;197;310
00-1-04-07-0836;4;107;96;207;311
00-1-04-08-0837;7;156;169;332;525
00-1-04-08-0838;8;178;128;314;525
00-1-04-08-0839;4;133;183;320;525
00-1-04-08-0840;5;128;171;304;525
00-1-04-08-0841;4;140;171;315;525
00-1-04-08-0842;5;131;173;309;528
00-1-04-08-0843;2;67;80;149;248
00-1-04-09-0844;1;83;23;107;192
00-1-04-09-0845;7;82;77;166;359
00-1-04-09-0846;3;83;80;166;284
00-1-04-09-0847;1;27;46;74;131
00-1-04-09-0848;3;91;107;201;333
00-1-04-09-0849;2;110;89;201;334
00-1-04-09-0850;1;36;21;58;113
00-1-04-09-0851;1;19;29;49;92
00-1-04-09-0852;2;32;45;79;147
00-1-04-09-0853;0;68;53;121;205
00-1-04-09-0854;0;16;10;26;41
00-1-05-01-0855;9;172;165;346;572
00-1-05-01-0856;5;217;151;373;572
00-1-05-01-0858;8;185;165;358;572
00-1-05-01-0859;14;154;163;331;572
00-1-05-01-0860;9;186;167;362;572
00-1-05-01-0861;17;146;179;342;572
00-1-05-01-0862;9;158;186;353;572
00-1-05-01-0863;13;198;154;365;579
00-1-05-01-0864;5;147;139;291;474
00-1-05-01-0865;18;194;154;366;595
00-1-05-01-0866;15;148;203;366;596
00-1-05-01-0867;16;208;126;350;624
00-1-05-01-0868;13;211;170;394;624
00-1-05-01-0869;2;10;14;26;54
00-1-05-02-0870;0;36;41;77;124
00-1-05-02-0871;12;162;167;341;584
00-1-05-02-0872;7;155;178;340;584
00-1-05-02-0873;17;165;183;365;584
00-1-05-02-0874;11;179;161;351;587
00-1-05-02-0875;0;0;11;11;24
00-1-05-02-0876;0;33;36;69;128
00-1-05-02-0877;0;91;40;131;195
00-1-05-02-0878;1;71;103;175;255
00-1-05-02-0879;1;5;23;29;46
00-1-05-03-0880;9;123;145;277;455
00-1-05-03-0881;15;103;146;264;456
00-1-05-03-0882;8;116;185;309;563
00-1-06-01-0883;3;179;160;342;600
00-1-06-01-0884;13;172;157;342;600
00-1-06-01-0885;12;192;153;357;600
00-1-06-01-0886;7;145;185;337;600
00-1-06-01-0887;13;164;162;339;600
00-1-06-01-0888;17;160;175;352;600
00-1-06-01-0889;9;188;158;355;600
00-1-06-01-0890;11;206;171;388;600
00-1-06-01-0891;8;174;157;339;600
00-1-06-01-0892;9;217;151;377;600
00-1-06-01-0893;11;192;179;382;600
00-1-06-01-0894;2;212;171;385;600
00-1-06-01-0895;8;196;168;372;600
00-1-06-01-0896;2;166;156;324;600
00-1-06-01-0897;6;149;163;318;600
00-1-06-01-0898;8;177;156;341;600
00-1-06-01-0899;6;203;161;370;600
00-1-06-01-0900;9;155;200;364;600
00-1-06-01-0902;3;182;156;341;600
00-1-06-01-0904;6;183;164;353;600
00-1-06-01-0905;9;181;152;342;600
00-1-06-01-0906;9;182;138;329;600
00-1-06-01-0907;6;157;166;329;600
00-1-06-01-0908;6;153;197;356;600
00-1-06-01-0909;9;206;158;373;600
00-1-06-01-0910;11;185;154;350;600
00-1-06-01-0911;6;168;140;314;600
00-1-06-01-0912;14;185;150;349;600
00-1-06-01-0913;13;175;154;342;575
00-1-06-01-0914;9;168;168;345;574
00-1-06-01-0915;7;162;182;351;600
00-1-06-01-0916;6;144;189;339;600
00-1-06-01-0917;16;156;165;337;600
00-1-06-01-0918;8;192;170;370;600
00-1-06-01-0919;5;147;173;325;600
00-1-06-01-0921;6;176;183;365;600
00-1-06-01-0922;6;133;213;352;600
00-1-06-01-0923;14;145;177;336;565
00-1-06-01-0924;4;153;160;317;564
00-1-06-01-0925;3;5;8;16;23
00-1-06-02-0926;6;169;117;292;466
00-1-06-02-0927;5;145;116;266;466
00-1-06-02-0928;5;164;113;282;468
00-1-06-02-0929;3;79;31;113;189
00-1-06-02-0930;5;79;101;185;285
00-1-06-03-0931;3;87;49;139;218
00-1-06-03-0932;12;213;157;382;600
00-1-06-03-0933;14;217;126;357;600
00-1-06-03-0934;11;189;165;365;600
00-1-06-03-0935;12;184;188;384;600
00-1-06-03-0936;5;176;170;351;581
00-1-06-03-0937;10;180;167;357;580
00-1-06-03-0939;2;117;94;213;358
00-1-06-03-0940;19;119;29;167;301
00-1-06-03-0941;3;243;81;327;519
00-1-06-04-0942;8;150;183;341;557
00-1-06-04-0943;6;193;163;362;557
00-1-06-04-0944;10;187;143;340;557
00-1-06-04-0945;11;179;168;358;557
00-1-06-04-0946;7;197;161;365;557
00-1-06-04-0947;8;209;158;375;562
00-1-06-04-0948;3;79;67;149;309
00-1-06-04-0949;2;191;123;316;558
00-1-06-05-0950;5;214;142;361;604
00-1-06-05-0951;2;27;29;58;93
00-1-06-05-0952;1;38;35;74;105
00-1-06-05-0953;6;77;60;143;208
00-1-06-06-0954;4;238;108;350;586
00-1-06-06-0955;0;42;22;64;131
00-1-06-07-0956;6;138;143;287;551
00-1-06-07-0957;2;191;128;321;551
00-1-06-07-0958;9;183;158;350;551
00-1-06-07-0959;4;170;132;306;551
00-1-06-07-0960;4;152;150;306;551
00-1-06-07-0961;10;160;145;315;551
00-1-06-07-0963;5;175;131;311;552
00-1-06-07-0964;6;142;135;283;566
00-1-06-07-0965;11;147;159;317;566
00-1-06-07-0966;6;129;158;293;566
00-1-06-07-0967;13;145;149;307;569
00-1-07-01-0968;16;194;179;389;580
00-1-07-01-0969;11;186;188;385;580
00-1-07-01-0971;17;167;191;375;580
00-1-07-01-0972;9;179;165;353;580
00-1-07-01-0973;12;187;170;369;580
00-1-07-01-0974;12;166;185;363;580
00-1-07-01-0975;8;191;180;379;580
00-1-07-01-0976;4;176;200;380;580
00-1-07-01-0977;10;183;199;392;580
00-1-07-01-0980;4;205;176;385;580
00-1-07-01-0981;10;174;172;356;580
00-1-07-01-0982;7;208;181;396;584
00-1-07-01-0983;4;141;101;246;356
00-1-07-01-0984;17;196;186;399;565
00-1-07-01-0985;11;238;141;390;565
00-1-07-01-0986;10;186;171;367;565
00-1-07-01-0987;10;200;162;372;568
00-1-07-01-0988;6;146;175;327;543
00-1-07-01-0989;9;145;177;331;543
00-1-07-01-0990;9;142;168;319;544
00-1-07-01-0991;0;106;73;179;329
00-1-07-02-0992;10;116;161;287;499
00-1-07-02-0993;8;110;174;292;499
00-1-07-02-0994;8;121;148;277;499
00-1-07-02-0995;7;116;121;244;502
00-1-07-02-0996;11;136;152;299;481
00-1-07-02-0997;7;120;151;278;481
00-1-07-02-0998;5;120;155;280;482
00-1-07-03-0999;8;122;158;288;496
00-1-07-03-1000;4;118;140;262;496
00-1-07-03-1001;4;113;162;279;497
00-1-07-03-1002;8;137;205;350;607
00-1-07-03-1003;4;94;113;211;358
00-1-07-03-1004;5;92;122;219;358
00-1-07-03-1005;5;92;120;217;362
00-1-07-03-1006;8;53;76;137;239
00-1-07-03-1007;5;46;48;99;157
00-1-07-03-1008;0;33;25;58;78
00-1-07-04-1009;1;82;108;191;277
00-1-07-05-1010;1;80;47;128;208
00-1-07-05-1011;3;108;126;237;325
00-1-07-05-1012;0;11;22;33;47
00-1-07-06-1013;8;115;155;278;462
00-1-07-06-1014;4;128;144;276;463
00-1-07-07-1015;9;97;163;269;518
00-1-07-07-1016;6;115;151;272;519
00-1-08-01-1017;19;194;161;374;610
00-1-08-01-1018;13;197;163;373;610
00-1-08-01-1019;17;223;154;394;610
00-1-08-01-1020;12;174;144;330;610
00-1-08-01-1021;11;191;183;385;610
00-1-08-01-1022;8;183;186;377;610
00-1-08-01-1023;8;206;151;365;610
00-1-08-01-1024;9;166;187;362;610
00-1-08-01-1025;10;185;166;361;610
00-1-08-01-1026;10;191;179;380;610
00-1-08-01-1027;20;184;161;365;610
00-1-08-01-1028;7;203;178;388;610
00-1-08-01-1029;20;180;178;378;610
00-1-08-01-1030;6;189;185;380;610
00-1-08-01-1031;14;167;185;366;610
00-1-08-01-1032;10;181;163;354;610
00-1-08-01-1033;9;160;189;358;610
00-1-08-01-1034;10;172;183;365;610
00-1-08-01-1035;21;196;174;391;610
00-1-08-01-1036;13;201;165;379;610
00-1-08-01-1037;15;220;158;393;610
00-1-08-01-1038;12;194;175;381;610
00-1-08-01-1039;12;186;159;357;610
00-1-08-01-1040;10;200;160;370;610
00-1-08-01-1041;5;194;165;364;610
00-1-08-01-1042;13;213;164;390;610
00-1-08-01-1043;11;199;172;382;610
00-1-08-01-1044;8;191;177;376;610
00-1-08-01-1045;11;196;185;392;610
00-1-08-01-1046;11;174;172;357;610
00-1-08-01-1047;10;203;154;367;610
00-1-08-01-1048;7;164;167;338;610
00-1-08-01-1049;17;190;174;381;627
00-1-08-01-1050;2;47;26;75;168
00-1-08-02-1051;13;169;152;334;499
00-1-08-02-1052;8;154;153;315;499
00-1-08-02-1053;10;163;150;323;499
00-1-08-02-1054;9;168;163;340;502
00-1-08-03-1055;17;210;171;398;613
00-1-08-03-1056;8;174;185;367;613
00-1-08-03-1057;12;219;168;399;613
00-1-08-03-1058;11;200;164;375;613
00-1-08-03-1059;9;201;170;380;613
00-1-08-03-1060;7;187;163;357;613
00-1-08-03-1061;16;198;174;388;613
00-1-08-03-1062;14;171;173;358;613
00-1-08-03-1063;4;181;178;363;613
00-1-08-03-1064;6;167;211;384;613
00-1-08-03-1065;7;176;173;356;613
00-1-08-03-1066;13;175;177;365;613
00-1-08-03-1067;0;172;179;351;613
00-1-08-03-1068;14;217;147;378;613
00-1-08-03-1069;5;213;183;401;613
00-1-08-03-1070;6;175;188;369;613
00-1-08-03-1071;9;195;160;364;613
00-1-08-03-1072;9;209;185;403;613
00-1-08-03-1073;5;189;176;370;625
00-1-08-03-1074;0;2;3;5;11
00-1-08-04-1075;23;213;159;395;600
00-1-08-04-1076;16;227;140;383;600
00-1-08-04-1077;17;201;167;385;600
00-1-08-04-1078;6;198;156;360;600
00-1-08-04-1079;8;196;174;378;600
00-1-08-04-1080;9;223;155;387;600
00-1-08-04-1081;10;198;187;395;600
00-1-08-04-1082;12;222;154;388;600
00-1-08-04-1083;9;187;181;377;600
00-1-08-04-1084;13;181;159;353;600
00-1-08-04-1085;12;192;163;367;600
00-1-08-04-1086;11;193;197;401;600
00-1-08-04-1087;14;202;163;379;600
00-1-08-04-1088;10;211;165;386;600
00-1-08-04-1089;10;185;172;367;600
00-1-08-04-1090;10;202;173;385;600
00-1-08-04-1091;9;176;166;351;600
00-1-08-04-1092;9;182;182;373;600
00-1-08-04-1093;12;183;160;355;600
00-1-08-04-1094;9;190;176;375;600
00-1-08-04-1095;18;199;151;368;600
00-1-08-04-1096;10;189;165;364;562
00-1-08-04-1097;14;178;168;360;561
00-1-08-05-1098;12;170;160;342;570
00-1-08-05-1099;7;192;154;353;570
00-1-08-05-1100;11;178;143;332;570
00-1-08-05-1101;16;180;151;347;570
00-1-08-05-1102;12;168;165;345;570
00-1-08-05-1103;11;173;153;337;570
00-1-08-05-1104;4;160;181;345;570
00-1-08-05-1105;9;162;178;349;570
00-1-08-05-1106;9;169;158;336;570
00-1-08-05-1107;8;163;178;349;579
00-1-08-05-1108;14;176;172;362;601
00-1-08-05-1109;6;176;187;369;601
00-1-08-05-1110;11;172;176;359;601
00-1-08-05-1111;12;157;189;358;601
00-1-08-05-1112;14;197;180;391;601
00-1-08-05-1113;14;165;181;360;601
00-1-08-05-1114;12;179;190;381;601
00-1-08-05-1115;10;172;175;357;601
00-1-08-05-1116;9;155;193;357;601
00-1-08-05-1117;15;185;192;392;601
00-1-08-05-1118;11;176;196;383;609
00-1-08-05-1119;14;137;183;334;611
00-1-08-05-1120;6;148;167;321;611
00-1-08-05-1121;10;147;169;326;611
00-1-08-05-1122;6;158;190;354;611
00-1-08-05-1123;15;146;197;358;611
00-1-08-05-1124;7;152;177;336;611
00-1-08-05-1125;11;150;189;350;611
00-1-08-05-1126;8;140;189;337;611
00-1-08-05-1127;14;156;173;343;611
00-1-08-05-1128;5;146;171;322;611
00-1-08-05-1129;14;155;179;348;611
00-1-08-05-1130;6;176;172;354;611
00-1-08-05-1131;10;151;195;356;611
00-1-08-05-1132;6;174;161;341;611
00-1-08-05-1133;16;166;166;348;611
00-1-08-05-1134;5;150;172;327;611
00-1-08-05-1135;7;124;188;319;611
00-1-08-05-1136;6;164;177;347;611
00-1-08-05-1137;9;164;175;348;612
00-1-08-06-1138;7;155;101;263;436
00-1-08-06-1139;8;129;111;248;436
00-1-08-06-1140;3;128;143;274;520
00-1-08-06-1141;5;128;150;283;520
00-1-08-06-1142;3;117;137;257;520
00-1-08-06-1143;10;116;149;275;520
00-1-08-06-1144;7;119;171;297;524
00-1-08-07-1145;13;126;179;318;620
00-1-08-07-1146;11;155;153;319;620
00-1-08-07-1147;12;134;165;311;620
00-1-08-07-1148;10;161;160;331;620
00-1-08-07-1149;10;154;152;316;620
00-1-08-07-1150;8;151;161;320;620
00-1-08-07-1151;7;141;170;318;620
00-1-08-07-1152;9;161;168;338;620
00-1-08-07-1153;5;140;182;327;620
00-1-08-07-1154;5;166;165;336;620
00-1-08-07-1155;5;155;149;309;620
00-1-08-07-1156;8;153;147;308;620
00-1-08-07-1157;13;148;178;339;620
00-1-08-07-1158;7;152;163;322;620
00-1-08-07-1159;5;139;153;297;620
00-1-08-07-1160;9;160;147;316;620
00-1-08-07-1161;10;147;170;327;627
00-1-08-07-1162;8;110;154;272;639
00-1-08-07-1163;4;118;137;259;639
00-1-08-07-1164;3;133;162;298;639
00-1-08-07-1165;6;117;138;261;639
00-1-08-07-1166;7;107;148;262;639
00-1-08-07-1167;12;100;154;266;639
00-1-08-07-1168;9;97;183;289;639
00-1-08-07-1169;4;111;172;287;639
00-1-08-07-1170;2;100;165;267;639
00-1-08-07-1171;7;96;185;288;641
00-1-09-01-1172;8;217;162;387;588
00-1-09-01-1173;9;218;173;400;588
00-1-09-01-1174;6;250;153;409;588
00-1-09-01-1175;12;213;151;376;588
00-1-09-01-1176;6;231;153;390;588
00-1-09-01-1177;4;240;141;385;588
00-1-09-01-1178;8;265;134;407;588
00-1-09-01-1179;3;215;182;400;588
00-1-09-01-1180;19;239;147;405;588
00-1-09-01-1181;8;221;161;390;588
00-1-09-01-1182;8;210;181;399;588
00-1-09-01-1183;7;221;148;376;588
00-1-09-01-1184;9;217;153;379;597
00-1-09-01-1185;11;231;166;408;611
00-1-09-01-1186;15;210;194;419;611
00-1-09-01-1187;9;218;169;396;613
00-1-09-02-1188;5;151;177;333;566
00-1-09-02-1189;9;155;155;319;566
00-1-09-02-1190;4;188;163;355;566
00-1-09-02-1191;6;194;145;345;566
00-1-09-02-1192;2;175;153;330;570
00-1-09-02-1193;5;91;82;178;403
00-1-09-03-1194;6;252;173;431;626
00-1-09-03-1195;11;228;153;392;626
00-1-09-03-1196;7;261;150;418;626
00-1-09-03-1197;9;258;150;417;626
00-1-09-03-1198;11;263;146;420;626
00-1-09-03-1199;8;257;137;402;626
00-1-09-03-1200;7;237;145;389;626
00-1-09-03-1201;7;230;138;375;626
00-1-09-03-1202;6;237;149;392;626
00-1-09-03-1203;4;250;142;396;626
00-1-09-03-1204;6;246;165;417;626
00-1-09-03-1205;9;273;152;434;626
00-1-09-03-1206;7;255;159;421;626
00-1-09-03-1207;9;199;191;399;626
00-1-09-03-1208;9;234;174;417;626
00-1-09-03-1209;8;134;140;282;448
00-1-09-03-1210;8;126;145;279;448
00-1-09-03-1211;6;149;145;300;450
00-1-09-03-1212;8;156;166;330;533
00-1-09-03-1213;6;179;152;337;533
00-1-09-03-1214;12;165;160;337;535
00-1-09-04-1215;5;242;159;406;633
00-1-09-04-1216;8;237;160;405;633
00-1-09-04-1217;8;222;160;390;633
00-1-09-04-1218;9;225;171;405;633
00-1-09-04-1219;10;238;150;398;633
00-1-09-04-1220;5;247;156;408;633
00-1-09-04-1221;14;227;190;431;633
00-1-09-04-1222;4;206;180;390;633
00-1-09-04-1223;10;238;169;417;637
00-1-09-04-1224;0;79;131;210;403
00-1-09-04-1225;4;94;138;236;404
00-1-09-05-1226;10;187;153;350;566
00-1-09-05-1227;9;200;147;356;566
00-1-09-05-1228;9;185;165;359;566
00-1-09-05-1229;6;193;162;361;566
00-1-09-05-1230;5;171;147;323;566
00-1-09-05-1231;5;186;187;378;566
00-1-09-05-1232;7;195;171;373;566
00-1-09-05-1233;8;234;144;386;566
00-1-09-05-1234;3;200;158;361;566
00-1-09-05-1235;10;202;163;375;571
00-1-09-06-1236;15;201;191;407;610
00-1-09-06-1237;6;177;175;358;610
00-1-09-06-1238;2;193;170;365;611
00-1-10-01-1239;12;150;174;336;607
00-1-10-01-1240;13;160;183;356;607
00-1-10-01-1241;3;129;209;341;607
00-1-10-01-1242;8;176;166;350;607
00-1-10-01-1243;7;166;205;378;607
00-1-10-01-1244;2;155;189;346;607
00-1-10-01-1245;10;161;172;343;607
00-1-10-01-1246;7;157;156;320;607
00-1-10-01-1247;7;152;179;338;607
00-1-10-01-1248;7;162;162;331;607
00-1-10-01-1249;5;162;175;342;607
00-1-10-01-1250;15;139;194;348;607
00-1-10-01-1251;8;183;172;363;607
00-1-10-01-1252;7;175;182;364;607
00-1-10-01-1253;0;155;170;325;607
00-1-10-01-1254;9;167;186;362;607
00-1-10-01-1255;9;170;178;357;610
00-1-10-02-1256;11;141;205;357;621
00-1-10-02-1257;12;163;209;384;621
00-1-10-02-1258;10;167;184;361;621
00-1-10-02-1259;7;190;181;378;621
00-1-10-02-1260;2;167;196;365;621
00-1-10-02-1261;8;151;228;387;621
00-1-10-02-1262;10;149;202;361;621
00-1-10-02-1263;16;137;206;359;621
00-1-10-02-1264;15;136;205;356;621
00-1-10-02-1265;11;141;193;345;621
00-1-10-02-1266;13;167;188;368;621
00-1-10-02-1267;9;146;213;368;621
00-1-10-02-1268;9;166;189;364;625
00-1-10-03-1269;8;151;171;330;560
00-1-10-03-1270;6;130;163;299;560
00-1-10-03-1271;7;135;167;309;561
00-1-10-03-1272;7;150;141;298;466
00-1-10-04-1273;9;120;198;327;600
00-1-10-04-1274;7;135;193;335;600
00-1-10-04-1275;11;124;195;330;600
00-1-10-04-1276;5;176;172;353;600
00-1-10-04-1277;12;149;147;308;600
00-1-10-04-1278;10;127;200;337;600
00-1-10-04-1279;7;123;176;306;600
00-1-10-04-1280;6;106;171;283;600
00-1-10-04-1281;24;158;175;357;600
00-1-10-04-1282;7;144;176;327;600
00-1-10-04-1283;13;132;184;329;600
00-1-10-04-1284;6;120;183;309;600
00-1-10-04-1285;7;122;172;301;563
00-1-10-04-1286;6;118;171;295;563
00-1-10-04-1287;7;142;139;288;575
00-1-10-04-1288;12;140;171;323;575
00-1-10-04-1289;6;110;191;307;575
00-1-10-04-1290;12;138;171;321;575
00-1-10-04-1291;4;142;154;300;575
00-1-10-04-1292;10;107;163;280;575
00-1-10-04-1293;13;107;167;287;575
00-1-10-04-1294;12;139;174;325;578
00-1-10-05-1295;9;142;169;320;587
00-1-10-05-1296;11;125;202;338;587
00-1-10-05-1297;13;158;152;323;587
00-1-10-05-1298;6;143;166;315;587
00-1-10-05-1299;2;135;163;300;587
00-1-10-05-1300;11;132;174;317;587
00-1-10-05-1301;4;155;144;303;587
00-1-10-05-1302;8;146;174;328;587
00-1-10-05-1303;11;145;174;330;587
00-1-10-05-1304;11;123;160;294;591
00-1-10-05-1305;14;138;170;322;600
00-1-10-05-1306;7;126;190;323;600
00-1-10-05-1307;10;126;203;339;600
00-1-10-05-1308;7;120;185;312;600
00-1-10-05-1309;5;157;143;305;600
00-1-10-05-1310;10;137;163;310;600
00-1-10-05-1311;10;131;186;327;600
00-1-10-05-1312;7;140;157;304;600
00-1-10-05-1313;9;113;209;331;600
00-1-10-05-1314;7;130;165;302;600
00-1-10-05-1315;15;127;179;321;600
00-1-10-05-1316;11;128;177;316;600
00-1-10-05-1317;15;108;192;315;600
00-1-10-05-1318;8;133;174;315;600
00-1-10-05-1319;7;127;183;317;600
00-1-10-05-1320;11;154;164;329;600
00-1-10-05-1321;5;101;163;269;613
00-1-10-05-1322;9;109;163;281;613
00-1-10-05-1323;7;93;169;269;613
00-1-10-05-1324;8;92;155;255;613
00-1-10-05-1325;9;104;163;276;613
00-1-10-05-1326;5;90;129;224;613
00-1-10-05-1327;8;91;134;233;619
00-1-11-01-1328;12;206;187;405;615
00-1-11-01-1329;5;219;190;414;615
00-1-11-01-1330;16;217;189;422;615
00-1-11-01-1331;10;211;168;389;615
00-1-11-01-1332;8;219;157;384;615
00-1-11-01-1333;10;183;186;379;615
00-1-11-01-1334;14;197;179;390;615
00-1-11-01-1335;13;202;171;386;615
00-1-11-01-1336;16;238;185;439;615
00-1-11-01-1337;15;190;204;409;615
00-1-11-01-1338;17;228;159;404;615
00-1-11-01-1339;15;216;183;414;615
00-1-11-01-1340;12;219;176;407;615
00-1-11-01-1342;16;217;156;389;615
00-1-11-01-1343;8;235;164;407;615
00-1-11-01-1344;9;232;178;419;615
00-1-11-01-1345;17;226;177;420;615
00-1-11-01-1346;11;228;167;406;615
00-1-11-01-1347;6;234;193;433;628
00-1-11-01-1348;11;203;182;396;568
00-1-11-01-1349;20;162;176;358;568
00-1-11-01-1350;10;184;182;376;568
00-1-11-01-1351;9;153;186;348;568
00-1-11-01-1352;17;173;183;373;568
00-1-11-01-1353;11;173;167;351;568
00-1-11-01-1354;9;161;205;375;573
00-1-11-02-1355;10;205;163;378;576
00-1-11-02-1356;8;181;166;355;576
00-1-11-02-1357;8;188;167;363;576
00-1-11-02-1358;11;212;158;381;576
00-1-11-02-1359;11;228;149;388;576
00-1-11-02-1360;10;196;184;390;576
00-1-11-02-1361;10;184;177;371;576
00-1-11-02-1362;4;191;120;315;576
00-1-11-02-1363;10;200;137;347;584
00-1-11-02-1364;10;157;114;281;512
00-1-11-02-1365;12;154;102;268;512
00-1-11-03-1366;5;169;188;362;611
00-1-11-03-1367;3;184;202;389;611
00-1-11-03-1368;14;183;185;382;611
00-1-11-03-1369;9;162;202;373;611
00-1-11-03-1370;9;181;179;369;611
00-1-11-03-1371;7;147;206;360;611
00-1-11-03-1372;13;145;187;345;611
00-1-11-03-1373;11;185;182;378;611
00-1-11-03-1374;8;156;213;377;611
00-1-11-03-1375;11;166;192;369;611
00-1-11-03-1376;13;192;182;387;611
00-1-11-03-1377;11;151;188;350;611
00-1-11-03-1378;8;175;186;369;611
00-1-11-03-1379;10;167;168;345;611
00-1-11-03-1380;12;159;161;332;611
00-1-11-03-1381;7;172;200;379;611
00-1-11-03-1382;7;184;191;382;614
00-1-11-04-1383;13;185;203;401;603
00-1-11-04-1384;9;182;191;382;603
00-1-11-04-1385;13;201;189;403;603
00-1-11-04-1386;14;199;201;414;603
00-1-11-04-1387;10;181;177;368;603
00-1-11-04-1388;8;187;196;391;603
00-1-11-04-1389;9;206;179;394;603
00-1-11-04-1390;10;193;189;392;603
00-1-11-04-1391;6;209;158;373;603
00-1-11-04-1392;13;180;175;368;603
00-1-11-04-1393;10;194;188;392;603
00-1-11-04-1394;11;188;200;399;603
00-1-11-04-1395;13;206;172;391;603
00-1-11-04-1396;10;175;198;383;603
00-1-11-04-1397;9;194;176;379;603
00-1-11-04-1398;9;202;170;381;603
00-1-11-04-1399;9;201;181;391;603
00-1-11-04-1400;9;210;198;417;603
00-1-11-04-1401;11;171;181;363;603
00-1-11-04-1402;11;171;195;377;603
00-1-11-04-1403;8;191;193;392;603
00-1-11-04-1404;12;210;186;408;603
00-1-11-04-1405;12;203;185;400;603
00-1-11-04-1406;13;174;190;377;603
00-1-11-04-1407;7;200;192;399;603
00-1-11-04-1408;9;202;198;409;603
00-1-11-04-1409;5;176;184;365;603
00-1-11-04-1410;11;202;189;402;603
00-1-11-04-1411;11;219;182;412;618
00-1-11-05-1412;11;191;149;351;609
00-1-11-05-1413;14;169;159;342;609
00-1-11-05-1414;7;166;158;331;609
00-1-11-05-1415;7;168;176;351;609
00-1-11-05-1416;6;178;161;345;609
00-1-11-05-1417;11;166;158;335;609
00-1-11-05-1418;10;174;144;328;609
00-1-11-05-1419;14;174;164;352;610
00-1-11-05-1420;11;117;79;207;426
00-1-11-05-1421;8;116;85;209;427
00-1-12-01-1422;8;227;159;394;608
00-1-12-01-1423;7;175;206;388;608
00-1-12-01-1424;6;213;176;395;608
00-1-12-01-1425;13;170;199;382;608
00-1-12-01-1426;13;210;201;424;608
00-1-12-01-1427;8;177;186;371;608
00-1-12-01-1428;10;215;165;390;609
00-1-12-01-1429;7;139;171;317;563
00-1-12-01-1430;6;168;129;303;563
00-1-12-01-1431;5;160;190;355;506
00-1-12-01-1432;11;147;168;326;507
00-1-12-01-1433;8;235;122;365;562
00-1-12-01-1434;9;188;169;366;562
00-1-12-01-1435;10;162;201;373;563
00-1-12-01-1436;0;12;11;23;29
00-1-12-02-1437;2;97;71;170;316
00-1-12-02-1438;2;101;86;189;316
00-1-12-02-1439;2;53;33;88;173
00-1-12-02-1440;1;13;15;29;85
00-1-12-02-1441;11;171;85;267;407
00-1-12-02-1442;6;165;82;253;403
00-1-12-02-1443;6;151;73;230;404
00-1-12-03-1444;9;215;202;426;596
00-1-12-03-1445;7;168;157;332;580
00-1-12-03-1446;5;170;150;325;580
00-1-12-03-1447;11;152;169;332;580
00-1-12-03-1448;9;186;172;367;582
00-1-12-03-1449;2;74;64;140;228
00-1-12-03-1450;2;127;97;226;376
00-1-12-03-1451;5;172;80;257;436
00-1-12-04-1452;8;105;152;265;495
00-1-12-04-1453;4;97;123;224;422
00-1-12-04-1454;0;77;35;112;171
00-1-12-04-1455;0;34;42;76;149
00-1-12-04-1456;4;149;82;235;377
00-1-12-05-1457;1;89;76;166;359
00-1-12-05-1458;4;88;111;203;359
00-1-12-05-1459;3;75;75;153;310
00-1-12-05-1460;6;51;57;114;251
00-1-12-05-1461;0;31;4;35;103
00-1-12-05-1462;0;10;18;28;73
00-1-12-05-1463;1;30;25;56;106
00-1-12-05-1464;3;40;54;97;194
00-1-12-05-1465;5;72;39;116;207
00-1-13-01-1466;4;211;176;391;600
00-1-13-01-1467;4;186;165;355;600
00-1-13-01-1468;6;220;164;390;600
00-1-13-01-1469;12;216;176;404;600
00-1-13-01-1470;11;202;173;386;600
00-1-13-01-1471;9;226;160;395;600
00-1-13-01-1472;12;200;182;394;600
00-1-13-01-1473;10;187;173;370;600
00-1-13-01-1474;16;215;183;414;600
00-1-13-01-1475;9;240;143;392;600
00-1-13-01-1476;6;219;156;381;600
00-1-13-01-1477;13;222;166;401;600
00-1-13-01-1478;11;219;156;386;600
00-1-13-01-1479;12;191;159;362;600
00-1-13-01-1480;5;215;165;385;600
00-1-13-01-1481;10;216;181;407;600
00-1-13-01-1482;8;178;179;365;600
00-1-13-01-1483;13;208;167;388;600
00-1-13-01-1484;10;242;173;425;600
00-1-13-01-1485;14;213;171;398;600
00-1-13-01-1486;6;217;183;406;600
00-1-13-01-1487;11;231;157;399;600
00-1-13-01-1488;7;196;178;381;600
00-1-13-01-1489;17;198;183;398;600
00-1-13-01-1490;13;226;179;418;617
00-1-13-01-1491;14;184;172;370;600
00-1-13-01-1492;8;197;190;395;600
00-1-13-01-1493;15;176;178;369;600
00-1-13-01-1494;8;182;178;368;600
00-1-13-01-1495;14;178;184;376;600
00-1-13-01-1496;11;223;171;405;600
00-1-13-01-1497;12;175;201;388;600
00-1-13-01-1498;4;168;186;358;600
00-1-13-01-1499;13;173;203;389;600
00-1-13-01-1500;15;178;185;378;578
00-1-13-01-1501;12;167;198;377;578
00-1-13-02-1502;1;154;175;330;591
00-1-13-02-1503;8;165;142;315;591
00-1-13-02-1504;8;143;171;322;591
00-1-13-02-1505;6;127;188;321;591
00-1-13-02-1506;4;140;162;306;591
00-1-13-02-1507;8;166;147;321;591
00-1-13-02-1508;7;165;145;317;591
00-1-13-02-1509;14;145;165;324;591
00-1-13-02-1510;5;112;153;270;591
00-1-13-02-1511;15;121;198;334;591
00-1-13-02-1512;12;160;179;351;591
00-1-13-02-1513;4;123;162;289;591
00-1-13-02-1514;9;161;163;333;601
00-1-13-03-1515;6;217;188;411;613
00-1-13-03-1516;12;212;182;406;613
00-1-13-03-1517;10;238;151;399;613
00-1-13-03-1518;23;217;178;418;613
00-1-13-03-1519;15;224;192;431;613
00-1-13-03-1520;16;215;166;397;613
00-1-13-03-1521;9;200;181;390;613
00-1-13-03-1522;12;201;190;403;613
00-1-13-03-1523;13;214;172;399;613
00-1-13-03-1524;13;221;180;414;613
00-1-13-03-1525;12;217;188;417;613
00-1-13-03-1526;9;236;167;412;613
00-1-13-03-1527;10;209;188;407;613
00-1-13-03-1528;11;242;185;438;621
00-1-13-04-1529;4;144;150;298;617
00-1-13-04-1530;8;131;167;306;617
00-1-13-04-1531;11;119;149;279;617
00-1-13-04-1532;5;149;154;308;617
00-1-13-04-1533;2;131;156;289;617
00-1-13-04-1534;7;128;165;300;617
00-1-13-04-1535;8;115;152;275;617
00-1-13-04-1536;10;107;184;301;617
00-1-13-04-1537;6;107;174;287;617
00-1-13-04-1538;10;123;162;295;617
00-1-13-04-1539;5;135;158;298;617
00-1-13-04-1540;5;132;164;301;617
00-1-13-04-1541;6;134;158;298;623
00-1-13-05-1542;5;191;190;386;609
00-1-13-05-1543;6;200;201;407;609
00-1-13-05-1544;15;147;211;373;609
00-1-13-05-1545;10;164;185;359;609
00-1-13-05-1547;18;183;185;386;609
00-1-13-05-1548;5;199;176;380;614
00-1-13-05-1549;12;203;166;381;580
00-1-13-05-1550;13;200;159;372;580
00-1-13-05-1551;10;190;162;362;580
00-1-13-05-1552;10;174;198;382;580
00-1-13-05-1553;5;172;179;356;580
00-1-13-05-1554;13;192;159;364;580
00-1-13-05-1555;4;169;181;354;580
00-1-13-05-1556;12;194;162;368;580
00-1-13-05-1557;9;183;183;375;580
00-1-13-05-1558;15;186;169;370;580
00-1-13-05-1559;10;208;155;373;589
00-1-14-01-1560;10;217;186;413;603
00-1-14-01-1561;7;225;173;405;603
00-1-14-01-1562;15;236;155;406;603
00-1-14-01-1563;9;253;172;434;603
00-1-14-01-1564;7;240;172;419;603
00-1-14-01-1565;12;255;158;425;603
00-1-14-01-1566;10;230;164;404;603
00-1-14-01-1567;19;215;156;390;603
00-1-14-01-1568;5;226;162;393;603
00-1-14-01-1569;12;222;178;412;603
00-1-14-01-1570;15;233;157;405;603
00-1-14-01-1571;11;251;148;410;603
00-1-14-01-1572;19;226;160;405;603
00-1-14-01-1573;10;254;144;408;603
00-1-14-01-1574;7;233;152;392;603
00-1-14-01-1575;10;240;164;414;603
00-1-14-01-1576;14;227;178;419;603
00-1-14-01-1577;9;212;166;387;603
00-1-14-01-1578;10;211;158;379;603
00-1-14-01-1579;12;232;150;394;603
00-1-14-01-1580;16;226;162;404;603
00-1-14-01-1581;10;195;187;392;603
00-1-14-01-1582;13;232;166;411;603
00-1-14-01-1583;17;229;141;387;603
00-1-14-01-1584;11;234;148;393;603
00-1-14-01-1585;5;203;152;360;603
00-1-14-01-1586;13;235;172;420;603
00-1-14-01-1587;19;174;190;383;603
00-1-14-01-1588;12;236;164;412;603
00-1-14-01-1589;7;231;171;409;603
00-1-14-01-1590;9;233;172;414;603
00-1-14-01-1592;17;221;169;407;603
00-1-14-01-1593;8;208;168;384;603
00-1-14-01-1594;8;235;158;401;603
00-1-14-01-1595;22;227;177;426;603
00-1-14-01-1596;3;251;145;399;626
00-1-14-01-1597;0;8;1;9;28
00-1-14-01-1598;11;189;155;355;536
00-1-14-01-1599;13;185;149;347;536
00-1-14-01-1600;10;183;162;355;536
00-1-14-01-1601;11;181;143;335;536
00-1-14-01-1602;9;171;159;339;536
00-1-14-01-1603;14;189;137;340;536
00-1-14-01-1604;9;192;169;370;536
00-1-14-02-1605;9;165;146;320;501
00-1-14-02-1606;13;154;165;332;501
00-1-14-02-1607;11;165;133;309;501
00-1-14-02-1608;8;144;147;299;501
00-1-14-02-1609;9;175;145;329;504
00-1-14-02-1610;9;142;164;315;571
00-1-14-02-1611;9;138;190;337;571
00-1-14-02-1612;11;136;175;322;571
00-1-14-02-1613;11;160;178;349;574
00-1-14-03-1614;11;213;195;419;624
00-1-14-03-1615;6;186;194;386;624
00-1-14-03-1616;12;174;184;370;624
00-1-14-03-1617;6;192;185;383;624
00-1-14-03-1618;8;176;218;402;624
00-1-14-03-1619;11;195;180;386;624
00-1-14-03-1620;9;190;185;384;624
00-1-14-03-1621;10;198;174;382;624
00-1-14-03-1622;8;178;194;380;624
00-1-14-03-1623;11;189;206;406;624
00-1-14-03-1624;14;194;176;384;624
00-1-14-03-1625;8;194;190;392;624
00-1-14-03-1626;5;185;207;397;624
00-1-14-03-1627;7;173;209;389;624
00-1-14-03-1628;9;184;214;407;624
00-1-14-03-1629;12;180;186;378;624
00-1-14-03-1630;9;190;201;400;624
00-1-14-03-1631;10;196;196;402;625
00-1-14-03-1632;8;163;147;318;581
00-1-14-03-1633;14;185;155;354;581
00-1-14-03-1634;13;181;174;368;581
00-1-14-03-1635;6;193;132;331;581
00-1-14-03-1636;19;167;170;356;581
00-1-14-03-1637;13;181;165;359;581
00-1-15-01-1638;7;228;118;353;600
00-1-15-01-1640;14;245;128;387;600
00-1-15-01-1641;11;215;128;354;600
00-1-15-01-1642;18;233;123;374;600
00-1-15-01-1643;12;247;114;373;600
00-1-15-01-1644;12;242;118;372;600
00-1-15-01-1645;11;224;106;341;600
00-1-15-01-1646;16;231;107;354;600
00-1-15-01-1647;12;228;143;383;600
00-1-15-01-1648;9;218;107;334;600
00-1-15-01-1649;8;188;132;328;600
00-1-15-01-1650;5;231;130;366;600
00-1-15-01-1651;19;199;130;348;600
00-1-15-01-1652;16;238;118;372;600
00-1-15-01-1653;13;198;121;332;599
00-1-15-01-1654;8;198;162;368;600
00-1-15-01-1655;12;205;141;358;600
00-1-15-01-1656;14;248;132;394;600
00-1-15-01-1657;12;193;152;357;600
00-1-15-01-1658;17;222;147;386;600
00-1-15-01-1659;15;238;146;399;600
00-1-15-01-1660;17;221;150;388;600
00-1-15-01-1661;16;232;169;417;600
00-1-15-01-1662;17;182;163;362;600
00-1-15-01-1663;14;225;128;367;600
00-1-15-01-1664;16;201;152;369;600
00-1-15-01-1665;12;220;169;401;600
00-1-15-01-1666;14;251;133;398;600
00-1-15-01-1667;11;225;157;393;600
00-1-15-01-1668;11;217;150;378;600
00-1-15-01-1669;14;203;158;375;600
00-1-15-01-1670;15;218;154;387;600
00-1-15-01-1671;19;229;151;399;595
00-1-15-01-1672;13;226;145;384;595
00-1-15-01-1673;2;20;12;34;65
00-1-15-02-1674;16;229;153;398;603
00-1-15-02-1675;11;262;150;423;603
00-1-15-02-1676;11;215;160;386;603
00-1-15-02-1677;17;237;138;392;603
00-1-15-02-1678;18;247;150;415;603
00-1-15-02-1679;8;249;146;403;603
00-1-15-02-1680;20;240;140;400;603
00-1-15-02-1681;16;227;143;386;603
00-1-15-02-1682;13;249;140;402;603
00-1-15-02-1683;13;254;137;404;603
00-1-15-02-1684;14;236;169;419;603
00-1-15-02-1685;15;249;143;407;603
00-1-15-02-1686;19;244;147;410;603
00-1-15-02-1687;15;243;147;405;612
00-1-15-02-1688;25;204;142;371;528
00-1-15-02-1689;11;204;161;376;528
00-1-15-02-1690;10;207;155;372;528
00-1-15-02-1691;9;198;145;352;528
00-1-15-02-1692;10;211;158;379;528
00-1-15-02-1693;16;212;125;353;528
00-1-15-02-1694;18;194;140;352;530
00-1-15-03-1695;11;212;131;354;546
00-1-15-03-1696;21;231;120;372;546
00-1-15-03-1697;13;211;126;350;546
00-1-15-03-1698;19;217;125;361;546
00-1-15-03-1699;9;247;119;375;548
00-1-15-04-1700;15;216;172;403;600
00-1-15-04-1701;15;226;163;404;600
00-1-15-04-1702;7;193;184;384;600
00-1-15-04-1703;9;217;170;396;600
00-1-15-04-1704;14;179;172;365;600
00-1-15-04-1705;6;223;156;385;600
00-1-15-04-1706;11;205;149;365;600
00-1-15-04-1707;10;223;157;390;600
00-1-15-04-1708;7;221;168;396;600
00-1-15-04-1709;11;176;154;341;600
00-1-15-04-1710;8;186;167;361;573
00-1-15-04-1711;5;193;159;357;573
00-1-16-01-1712;5;144;139;288;486
00-1-16-01-1713;4;157;128;289;486
00-1-16-01-1714;7;114;133;254;486
00-1-16-02-1715;1;204;165;370;522
00-1-16-03-1716;6;106;136;248;421
00-1-16-03-1717;3;144;146;293;638
00-1-16-04-1718;1;30;42;73;112
00-1-16-04-1719;1;11;25;37;76
00-1-16-04-1720;0;82;25;107;213
00-1-16-04-1721;1;22;30;53;75
00-1-16-05-1722;5;105;55;165;298
00-1-16-05-1723;1;51;22;74;129
00-1-16-05-1724;0;79;28;107;199
00-1-16-05-1725;5;110;153;268;438
00-1-16-05-1726;3;117;88;208;324
00-1-16-05-1727;0;21;24;45;71
00-1-17-01-1728;8;155;161;324;572
00-1-17-01-1729;12;173;182;367;572
00-1-17-01-1730;27;176;153;356;572
00-1-17-01-1731;15;167;148;330;572
00-1-17-01-1732;11;150;134;295;572
00-1-17-01-1733;14;150;172;336;572
00-1-17-01-1734;13;211;173;397;574
00-1-17-01-1735;1;6;19;26;47
00-1-17-02-1736;11;114;82;207;338
00-1-17-03-1737;7;214;132;353;568
00-1-17-03-1738;2;82;56;140;202
00-1-17-03-1739;9;105;128;242;340
00-1-17-03-1740;4;75;63;142;222
00-1-17-03-1741;3;36;45;84;128
00-1-18-01-1742;10;239;172;421;613
00-1-18-01-1743;17;215;147;379;613
00-1-18-01-1744;14;197;172;383;613
00-1-18-01-1745;6;236;156;398;613
00-1-18-01-1746;9;230;158;397;613
00-1-18-01-1747;9;223;174;406;613
00-1-18-01-1748;6;224;145;375;613
00-1-18-01-1749;9;221;157;387;613
00-1-18-01-1750;15;173;159;347;613
00-1-18-01-1751;11;198;153;362;613
00-1-18-01-1752;12;226;140;378;613
00-1-18-01-1753;1;202;172;375;613
00-1-18-01-1754;15;185;161;361;613
00-1-18-01-1755;7;184;155;346;613
00-1-18-01-1756;8;197;171;376;613
00-1-18-01-1757;11;212;172;395;613
00-1-18-01-1758;15;202;159;376;613
00-1-18-01-1759;10;189;186;385;613
00-1-18-01-1760;13;222;151;386;619
00-1-18-01-1761;8;235;139;382;554
00-1-18-01-1762;11;237;149;397;554
00-1-18-01-1763;10;203;152;365;554
00-1-18-01-1764;11;229;144;384;554
00-1-18-01-1765;9;227;160;396;554
00-1-18-01-1766;13;228;166;407;554
00-1-18-01-1767;14;250;136;400;557
00-1-18-01-1768;15;239;136;390;581
00-1-18-01-1769;8;278;129;415;581
00-1-18-01-1770;14;255;139;408;581
00-1-18-01-1771;10;236;143;389;581
00-1-18-01-1772;9;260;157;426;581
00-1-18-01-1773;10;259;146;415;581
00-1-18-01-1774;12;272;138;422;587
00-1-18-01-1775;7;210;125;342;562
00-1-18-01-1776;22;207;158;387;562
00-1-18-01-1777;13;253;106;372;562
00-1-18-01-1778;11;219;147;377;562
00-1-18-01-1779;11;233;123;367;562
00-1-18-01-1780;12;211;143;366;562
00-1-18-01-1781;13;217;144;374;562
00-1-18-01-1782;13;223;141;377;562
00-1-18-01-1783;7;207;145;359;567
00-1-18-01-1784;0;8;10;18;32
00-1-18-02-1785;11;226;141;378;580
00-1-18-02-1786;12;198;153;363;580
00-1-18-02-1787;8;199;148;355;580
00-1-18-02-1788;9;218;162;389;580
00-1-18-02-1789;11;211;147;369;580
00-1-18-02-1790;7;177;189;373;580
00-1-18-02-1791;11;198;172;381;580
00-1-18-02-1792;8;197;152;357;580
00-1-18-02-1793;7;189;170;366;580
00-1-18-02-1794;10;201;178;389;580
00-1-18-02-1795;15;201;134;350;580
00-1-18-02-1796;8;191;167;366;580
00-1-18-02-1797;4;217;162;383;580
00-1-18-02-1799;11;190;135;336;580
00-1-18-02-1800;15;207;144;366;580
00-1-18-02-1801;7;198;173;378;580
00-1-18-02-1802;12;230;166;408;596
00-1-18-03-1803;6;312;112;430;556
00-1-18-03-1804;7;288;117;412;556
00-1-18-03-1805;9;290;120;419;556
00-1-18-03-1806;7;288;110;405;556
00-1-18-03-1807;14;294;100;408;556
00-1-18-03-1808;11;280;115;406;556
00-1-18-03-1809;10;310;103;423;556
00-1-18-03-1810;11;296;116;423;556
00-1-18-03-1811;12;275;113;400;556
00-1-18-03-1812;13;295;120;428;562
00-1-18-04-1813;6;161;159;326;581
00-1-18-04-1814;13;151;159;323;581
00-1-18-04-1815;13;180;159;352;581
00-1-18-04-1816;12;149;153;314;581
00-1-18-04-1817;6;180;160;346;581
00-1-18-04-1818;7;165;142;314;581
00-1-18-04-1819;7;173;173;353;581
00-1-18-04-1820;11;188;152;351;584
00-1-18-04-1821;3;125;137;265;560
00-1-18-04-1822;5;89;133;227;560
00-1-18-04-1823;6;131;120;257;560
00-1-18-04-1824;7;137;126;270;560
00-1-18-04-1825;7;114;118;239;560
00-1-18-04-1826;6;138;141;285;560
00-1-18-04-1827;3;111;134;248;560
00-1-18-04-1828;6;105;160;271;560
00-1-18-04-1829;4;110;124;238;560
00-1-18-04-1830;5;117;122;244;560
00-1-18-04-1831;8;145;132;285;564
00-1-19-01-1832;7;100;233;340;582
00-1-19-01-1833;10;125;206;341;582
00-1-19-01-1834;5;134;193;332;582
00-1-19-01-1835;9;145;207;361;582
00-1-19-01-1836;8;113;211;332;582
00-1-19-01-1837;7;139;188;334;582
00-1-19-01-1838;11;126;209;346;582
00-1-19-01-1839;12;113;211;336;582
00-1-19-01-1840;7;119;206;332;582
00-1-19-01-1841;10;116;216;342;582
00-1-19-01-1842;16;144;195;355;582
00-1-19-01-1843;8;128;225;361;593
00-1-19-01-1844;0;130;110;240;419
00-1-19-01-1845;4;91;136;231;419
00-1-19-01-1846;4;98;111;213;420
00-1-19-01-1847;1;99;95;195;397
00-1-19-01-1848;8;36;157;201;364
00-1-19-01-1849;9;49;154;212;364
00-1-19-01-1850;7;100;195;302;480
00-1-19-01-1851;6;106;178;290;480
00-1-19-01-1852;11;81;175;267;480
00-1-19-01-1853;9;111;187;307;483
00-1-19-01-1854;6;92;96;194;323
00-1-19-01-1855;8;113;217;338;567
00-1-19-01-1856;15;135;198;348;567
00-1-19-01-1857;12;123;153;288;479
00-1-19-01-1858;8;133;151;292;479
00-1-19-01-1859;0;38;48;86;167
00-1-19-01-1860;8;47;69;124;211
00-1-19-01-1861;7;25;46;78;166
00-1-19-01-1862;5;64;181;250;509
00-1-19-01-1863;5;79;154;238;509
00-1-19-01-1864;6;80;166;252;510
00-1-19-01-1865;5;118;226;349;541
00-1-19-01-1866;8;93;215;316;541
00-1-19-01-1867;9;117;170;296;541
00-1-19-01-1868;10;86;195;291;529
00-1-19-01-1869;7;116;180;303;529
00-1-19-01-1870;11;95;207;313;529
00-1-19-01-1871;3;107;190;300;529
00-1-19-01-1872;6;101;182;289;529
00-1-19-01-1873;7;106;203;316;529
00-1-19-01-1874;6;110;199;315;530
00-1-19-01-1875;4;41;131;176;326
00-1-19-01-1876;3;63;106;172;326
00-1-19-01-1877;5;78;162;245;409
00-1-19-01-1878;1;94;143;238;410
00-1-19-01-1879;19;112;215;346;600
00-1-19-01-1880;13;106;211;330;600
00-1-19-01-1881;6;120;223;349;600
00-1-19-01-1882;14;99;220;333;588
00-1-19-01-1883;13;116;226;355;588
00-1-19-01-1884;13;146;157;316;544
00-1-19-01-1885;8;47;109;164;270
00-1-19-01-1886;12;108;211;331;573
00-1-19-01-1887;6;111;190;307;574
00-1-19-01-1888;9;80;128;217;392
00-1-19-01-1889;4;81;134;219;392
00-1-19-01-1890;13;56;153;222;532
00-1-19-01-1891;3;50;170;223;532
00-1-19-01-1892;9;61;145;215;532
00-1-19-01-1893;1;80;159;240;532
00-1-19-01-1894;9;85;143;237;534
00-1-19-01-1895;11;154;202;367;603
00-1-19-01-1896;12;144;197;353;603
00-1-19-01-1897;8;158;229;395;603
00-1-19-01-1898;7;177;202;386;603
00-1-19-01-1899;17;155;199;371;607
00-1-19-01-1900;9;126;214;349;590
00-1-19-01-1901;32;118;225;375;590
00-1-19-01-1903;10;123;207;340;560
00-1-19-01-1904;9;114;201;324;560
00-1-19-01-1905;17;126;191;334;560
00-1-19-01-1906;3;102;188;293;520
00-1-19-01-1907;8;105;194;307;520
00-1-19-01-1908;9;98;190;297;520
00-1-19-01-1909;11;106;200;317;520
00-1-19-01-1910;3;106;176;285;520
00-1-19-01-1911;7;99;187;293;521
00-1-19-01-1912;8;56;146;210;418
00-1-19-01-1913;9;74;124;207;418
00-1-19-02-1914;7;87;179;273;454
00-1-19-02-1915;11;90;181;282;454
00-1-19-02-1916;4;94;164;262;455
00-1-19-02-1917;14;122;240;376;616
00-1-19-02-1918;6;96;185;287;541
00-1-19-02-1919;11;87;188;286;541
00-1-19-02-1920;11;90;195;296;541
00-1-19-02-1921;8;92;146;246;364
00-1-19-02-1922;6;75;143;224;364
00-1-19-02-1923;0;67;48;115;147
00-1-19-02-1924;2;121;154;277;461
00-1-19-02-1925;7;77;151;235;418
00-1-19-03-1926;5;111;222;338;610
00-1-19-03-1927;6;116;226;348;610
00-1-19-03-1929;6;133;215;354;610
00-1-19-03-1930;6;102;249;357;610
00-1-19-03-1931;8;104;261;373;612
00-1-19-03-1932;5;106;117;228;409
00-1-19-03-1933;10;78;142;230;409
00-1-19-03-1934;7;89;190;286;503
00-1-19-03-1935;12;81;205;298;503
00-1-19-03-1936;10;68;192;270;503
00-1-19-03-1937;8;108;185;301;503
00-1-19-03-1938;6;89;168;263;505
00-1-19-03-1939;12;141;192;345;518
00-1-19-03-1940;15;163;215;393;611
00-1-19-03-1941;11;102;212;325;501
00-1-19-03-1942;9;101;199;309;502
00-1-19-03-1943;8;123;219;350;600
00-1-19-03-1944;11;109;212;332;600
00-1-19-03-1945;13;139;220;372;600
00-1-19-03-1946;6;143;203;352;600
00-1-19-03-1947;7;135;212;354;600
00-1-19-03-1948;9;110;206;325;574
00-1-19-03-1949;9;124;183;316;574
00-1-19-03-1950;7;122;214;343;558
00-1-19-03-1951;8;123;220;351;558
00-1-19-03-1952;15;108;191;314;558
00-1-19-03-1953;4;107;203;314;558
00-1-19-03-1954;16;117;197;330;558
00-1-19-03-1955;10;105;201;316;558
00-1-19-03-1956;9;97;194;300;600
00-1-19-03-1957;5;99;200;304;600
00-1-19-03-1958;12;111;184;307;600
00-1-19-03-1959;8;86;219;313;600
00-1-19-03-1960;8;99;185;292;600
00-1-19-03-1961;5;118;219;342;600
00-1-19-03-1962;5;117;180;302;571
00-1-19-03-1963;1;124;180;305;571
00-1-19-03-1964;8;164;69;241;714
00-1-19-03-1965;0;36;15;51;68
00-1-19-03-1966;4;83;171;258;538
00-1-19-03-1967;7;93;160;260;538
00-1-19-03-1968;12;84;157;253;538
00-1-19-03-1969;6;67;162;235;540
00-1-19-03-1970;10;142;201;353;600
00-1-19-03-1971;14;127;227;368;600
00-1-19-03-1972;10;109;225;344;600
00-1-19-03-1973;10;96;228;334;600
00-1-19-03-1974;14;103;188;305;561
00-1-19-03-1975;10;94;193;297;560
00-1-19-03-1976;8;103;217;328;595
00-1-19-03-1977;6;120;193;319;595
00-1-19-03-1978;2;83;24;109;209
00-1-19-04-1979;10;77;182;269;461
00-1-19-04-1980;9;78;174;261;461
00-1-19-04-1981;11;86;184;281;461
00-1-19-04-1982;4;119;128;251;340
00-1-19-04-1983;8;106;173;287;418
00-1-19-04-1984;10;132;140;282;419
00-1-19-04-1985;6;76;85;167;276
00-1-19-04-1986;1;74;53;128;229
00-1-19-04-1987;6;112;150;268;461
00-1-19-04-1988;6;144;123;273;461
00-1-19-04-1989;10;47;152;209;295
00-1-19-04-1990;7;66;89;162;245
00-1-19-04-1991;3;57;27;87;148
00-1-19-04-1992;0;21;23;44;102
00-1-19-04-1993;7;60;69;136;242
00-1-19-04-1994;2;63;66;131;250
00-1-19-05-1995;1;91;167;259;472
00-1-19-05-1996;3;71;187;261;472
00-1-19-05-1997;5;96;148;249;474
00-1-19-05-1998;4;119;207;330;601
00-1-19-05-1999;2;60;192;254;479
00-1-19-05-2000;1;95;144;240;470
00-1-19-05-2001;0;102;120;222;409
00-1-19-05-2002;4;87;124;215;410
00-1-19-05-2003;9;56;119;184;423
00-1-19-05-2004;3;60;144;207;423
00-1-19-05-2005;7;93;131;231;424
00-1-19-05-2006;2;69;103;174;362
00-1-19-05-2007;2;49;81;132;362
00-1-19-05-2008;1;64;126;191;401
00-1-19-05-2009;2;59;116;177;401
00-1-19-05-2010;2;58;56;116;238
00-1-19-06-2011;7;111;125;243;356
00-1-19-06-2012;7;101;129;237;356
00-1-19-06-2013;4;105;149;258;463
00-1-19-06-2014;3;101;167;271;463
00-1-19-06-2015;14;116;182;312;464
00-1-19-06-2016;7;124;170;301;564
00-1-19-06-2017;14;143;166;323;564
00-1-19-06-2018;9;129;108;246;397
00-1-19-06-2019;3;64;55;122;186
00-1-19-06-2020;6;52;62;120;175
00-1-19-06-2021;5;102;156;263;479
00-1-19-06-2022;16;117;163;296;470
00-1-19-06-2023;16;120;136;272;470
00-1-19-06-2024;1;39;69;109;206
00-1-19-06-2025;1;81;138;220;401
00-1-19-07-2026;8;80;176;264;488
00-1-19-07-2027;6;59;192;257;488
00-1-19-07-2028;3;65;174;242;490
00-1-19-07-2029;4;104;234;342;537
00-1-19-07-2030;4;41;103;148;303
00-1-19-07-2031;0;13;33;46;101
00-1-19-07-2032;1;43;111;155;264
00-1-19-07-2033;9;90;170;269;489
00-1-19-07-2034;4;76;172;252;489
00-1-19-07-2035;2;33;111;146;221
00-1-19-07-2036;0;79;73;152;263
00-1-19-07-2037;0;18;52;70;135
00-1-19-07-2038;1;69;47;117;206
00-1-19-08-2039;5;99;223;327;600
00-1-19-08-2040;8;109;171;288;600
00-1-19-08-2041;4;106;158;268;600
00-1-19-08-2042;7;103;169;279;595
00-1-19-08-2043;11;96;176;283;595
00-1-19-08-2044;3;66;187;256;500
00-1-19-08-2045;9;67;127;203;390
00-1-19-08-2046;10;89;122;221;391
00-1-19-08-2047;8;140;156;304;603
00-1-19-08-2048;6;162;185;353;603
00-1-19-08-2049;10;153;166;329;603
00-1-19-08-2050;3;89;161;253;433
00-1-19-08-2051;5;76;168;249;433
00-1-19-08-2052;5;118;177;300;601
00-1-19-08-2053;6;110;174;290;601
00-1-19-09-2054;8;127;227;362;615
00-1-19-09-2055;3;100;83;186;354
00-1-19-09-2056;6;47;112;165;337
00-1-19-09-2057;2;48;133;183;337
00-1-19-09-2058;0;7;16;23;82
00-1-19-09-2059;4;97;106;207;318
00-1-19-10-2060;1;108;117;226;469
00-1-19-10-2061;9;129;94;232;469
00-1-19-10-2062;1;106;75;182;292
00-1-19-10-2063;3;14;57;74;133
00-1-19-10-2064;2;29;54;85;138
00-1-19-10-2065;4;131;158;293;529
00-1-19-10-2066;2;69;75;146;262
00-1-19-10-2067;1;61;33;95;193
00-1-19-11-2068;12;145;176;333;534
00-1-19-11-2069;13;151;134;298;534
00-1-19-11-2070;11;137;158;306;535
00-1-19-11-2071;5;62;33;100;170
00-1-19-11-2072;6;71;75;152;274
00-1-19-11-2073;3;89;84;176;257
00-1-19-11-2074;3;34;49;86;173
00-1-19-11-2075;4;72;108;184;350
00-1-19-11-2076;7;69;45;121;184
00-1-19-11-2077;4;80;46;130;216
00-1-19-11-2078;11;189;142;342;547
00-1-19-11-2079;6;28;46;80;101
00-1-19-11-2080;0;6;20;26;39
00-1-19-12-2081;11;80;118;209;337
00-1-19-12-2082;2;41;73;116;228
00-1-19-12-2083;4;134;110;248;380
00-1-19-12-2084;4;84;57;145;324
00-1-19-12-2085;6;94;163;263;527
00-1-19-12-2086;3;88;198;289;528
00-1-20-01-2087;20;151;184;355;572
00-1-20-01-2088;11;202;124;337;572
00-1-20-01-2089;11;152;157;320;572
00-1-20-01-2090;15;172;149;336;572
00-1-20-01-2091;10;161;145;316;575
00-1-20-01-2092;7;145;133;285;520
00-1-20-02-2093;14;123;103;240;407
00-1-20-02-2094;7;124;93;224;408
00-1-20-02-2095;2;76;63;141;247
00-1-20-02-2096;4;55;11;70;152
00-1-20-03-2097;6;124;89;219;357
00-1-20-03-2098;5;120;84;209;357
00-1-20-03-2099;3;117;81;201;322
00-1-20-03-2100;1;84;92;177;261
00-1-20-03-2101;2;37;43;82;108
00-1-20-04-2102;4;181;106;291;440
00-1-20-04-2103;1;167;117;285;441
00-1-20-04-2105;2;90;24;116;161
00-1-20-05-2107;17;191;100;308;438
00-1-20-05-2108;15;175;116;306;439
00-1-20-05-2109;8;184;48;240;348
00-1-20-05-2110;4;76;27;107;159
00-1-20-05-2111;0;37;4;41;51
00-1-20-06-2112;10;214;142;366;568
00-1-20-06-2113;13;95;86;194;292
00-2-01-01-2114;2;181;196;379;578
00-2-01-01-2115;12;204;168;384;578
00-2-01-01-2116;3;212;172;387;578
00-2-01-01-2117;7;181;180;368;578
00-2-01-01-2118;7;215;135;357;578
00-2-01-01-2119;9;222;141;372;578
00-2-01-01-2120;8;191;176;375;578
00-2-01-01-2121;10;207;167;384;578
00-2-01-01-2122;9;210;160;379;578
00-2-01-01-2123;9;195;176;380;582
00-2-01-01-2124;6;186;172;364;592
00-2-01-01-2125;6;167;195;368;592
00-2-01-01-2126;9;185;164;358;592
00-2-01-01-2127;8;201;167;376;592
00-2-01-01-2128;5;157;207;369;592
00-2-01-01-2129;8;190;185;383;592
00-2-01-01-2130;12;194;166;372;592
00-2-01-01-2131;6;204;154;364;592
00-2-01-01-2132;4;212;202;418;592
00-2-01-01-2133;11;177;183;371;592
00-2-01-01-2134;5;174;196;375;592
00-2-01-01-2135;5;192;189;386;592
00-2-01-01-2136;9;174;199;382;592
00-2-01-01-2137;10;175;191;376;592
00-2-01-01-2138;11;194;173;378;592
00-2-01-01-2139;14;179;201;394;592
00-2-01-01-2140;5;199;177;381;592
00-2-01-01-2141;16;175;177;368;607
00-2-01-01-2142;13;153;203;369;601
00-2-01-01-2143;10;148;192;350;601
00-2-01-01-2144;10;160;209;379;601
00-2-01-01-2145;6;150;198;354;601
00-2-01-01-2146;6;153;200;359;601
00-2-01-01-2147;7;138;177;322;601
00-2-01-01-2148;9;122;225;356;601
00-2-01-01-2149;16;168;189;373;601
00-2-01-01-2150;4;169;174;347;601
00-2-01-01-2151;5;134;198;337;601
00-2-01-01-2152;6;156;197;359;601
00-2-01-01-2153;7;153;214;374;601
00-2-01-01-2154;9;169;194;372;601
00-2-01-01-2155;9;165;191;365;601
00-2-01-01-2156;11;138;212;361;601
00-2-01-01-2157;12;171;184;367;601
00-2-01-01-2158;16;168;189;373;604
00-2-01-01-2159;14;153;172;339;601
00-2-01-01-2160;5;136;182;323;601
00-2-01-01-2161;5;141;184;330;601
00-2-01-01-2162;6;143;160;309;601
00-2-01-01-2163;9;140;165;314;601
00-2-01-01-2164;6;142;165;313;601
00-2-01-01-2165;17;147;169;333;601
00-2-01-01-2166;10;138;198;346;603
00-2-01-01-2167;0;29;13;42;131
00-2-01-01-2168;5;147;168;320;482
00-2-01-01-2169;3;138;154;295;482
00-2-01-01-2170;4;156;149;309;482
00-2-01-01-2171;5;161;152;318;482
00-2-01-01-2172;5;156;139;300;472
00-2-01-01-2173;7;159;150;316;472
00-2-01-01-2174;9;153;147;309;472
00-2-01-01-2175;4;176;140;320;474
00-2-01-01-2176;9;160;193;362;585
00-2-01-01-2177;9;153;192;354;585
00-2-01-01-2178;5;158;206;369;585
00-2-01-01-2179;8;161;148;317;585
00-2-01-01-2180;11;158;180;349;585
00-2-01-01-2181;5;140;175;320;585
00-2-01-01-2182;11;159;163;333;585
00-2-01-01-2183;10;172;181;363;585
00-2-01-01-2184;9;159;201;369;585
00-2-01-01-2185;10;162;176;348;592
00-2-01-02-2186;6;131;201;338;615
00-2-01-02-2187;5;167;172;344;615
00-2-01-02-2188;2;141;168;311;615
00-2-01-02-2189;2;133;184;319;615
00-2-01-02-2190;1;129;187;317;615
00-2-01-02-2191;7;125;180;312;615
00-2-01-02-2192;6;150;180;336;615
00-2-01-02-2193;4;127;193;324;615
00-2-01-02-2194;8;105;158;271;615
00-2-01-02-2195;5;128;181;314;615
00-2-01-02-2196;8;109;164;281;615
00-2-01-02-2197;7;145;207;359;615
00-2-01-02-2199;5;133;186;324;615
00-2-01-02-2200;8;116;199;323;615
00-2-01-02-2201;10;137;181;328;617
00-2-01-02-2202;10;151;202;363;589
00-2-01-02-2203;8;162;214;384;589
00-2-01-02-2204;5;149;192;346;589
00-2-01-02-2205;5;160;175;340;589
00-2-01-02-2206;3;124;203;330;589
00-2-01-02-2207;6;154;204;364;589
00-2-01-02-2208;6;146;178;330;589
00-2-01-02-2209;6;166;188;360;589
00-2-01-02-2210;11;146;191;348;589
00-2-01-02-2211;6;144;215;365;589
00-2-01-02-2212;6;154;208;368;589
00-2-01-02-2213;16;150;184;350;600
00-2-01-02-2214;10;133;145;288;549
00-2-01-02-2215;9;152;150;311;549
00-2-01-02-2216;12;138;128;278;550
00-2-01-02-2217;5;115;204;324;539
00-2-01-02-2218;10;160;167;337;539
00-2-01-02-2219;6;143;189;338;539
00-2-01-02-2220;4;150;181;335;539
00-2-01-02-2221;7;121;178;306;539
00-2-01-02-2222;6;146;190;342;539
00-2-01-02-2223;7;142;179;328;539
00-2-01-02-2224;9;131;172;312;540
00-2-01-02-2225;9;174;197;380;612
00-2-01-02-2226;14;146;235;395;612
00-2-01-02-2227;6;160;176;342;612
00-2-01-02-2228;6;176;205;387;612
00-2-01-02-2229;11;134;208;353;612
00-2-01-02-2230;8;165;211;384;612
00-2-01-02-2231;10;154;187;351;612
00-2-01-02-2232;8;152;213;373;612
00-2-01-02-2233;9;155;195;359;612
00-2-01-02-2234;9;150;198;357;612
00-2-01-02-2235;9;170;191;370;612
00-2-01-02-2236;8;175;198;381;612
00-2-01-02-2237;8;166;212;386;612
00-2-01-02-2238;12;170;192;374;612
00-2-01-02-2239;9;141;207;357;612
00-2-01-02-2240;6;178;185;369;612
00-2-01-02-2241;5;152;195;352;612
00-2-01-02-2242;21;178;184;383;612
00-2-01-02-2243;10;181;172;363;612
00-2-01-02-2244;11;157;196;364;616
00-2-01-03-2245;7;132;200;339;570
00-2-01-03-2246;13;133;158;304;570
00-2-01-03-2247;2;142;194;338;570
00-2-01-03-2248;10;149;189;348;570
00-2-01-03-2249;5;150;181;336;574
00-2-01-03-2250;5;105;142;252;506
00-2-01-03-2251;4;96;174;274;506
00-2-01-03-2252;11;122;163;296;507
00-2-01-03-2253;11;116;164;291;507
00-2-01-03-2254;3;128;181;312;509
00-2-01-04-2255;10;154;201;365;562
00-2-01-04-2256;7;142;198;347;562
00-2-01-04-2257;6;156;189;351;562
00-2-01-04-2258;2;155;184;341;562
00-2-01-04-2259;7;143;196;346;566
00-2-01-04-2260;15;145;192;352;600
00-2-01-04-2261;9;154;190;353;600
00-2-01-04-2262;6;141;200;347;600
00-2-01-04-2263;8;130;163;301;600
00-2-01-04-2264;6;152;187;345;600
00-2-01-04-2265;4;135;198;337;600
00-2-01-04-2266;9;151;200;360;600
00-2-01-04-2267;7;147;203;357;600
00-2-01-04-2268;7;154;161;322;600
00-2-01-04-2269;4;115;213;332;600
00-2-01-04-2270;7;156;173;336;600
00-2-01-04-2271;9;144;187;340;600
00-2-01-04-2272;7;118;225;350;600
00-2-01-04-2273;16;134;178;328;600
00-2-01-04-2274;3;140;172;315;565
00-2-01-04-2275;10;137;200;347;565
00-2-01-04-2276;5;168;203;376;613
00-2-01-04-2277;9;183;163;355;613
00-2-01-04-2278;4;150;186;340;613
00-2-01-04-2279;3;145;167;315;613
00-2-01-04-2280;11;177;161;349;613
00-2-01-04-2281;6;132;205;343;613
00-2-01-04-2282;5;160;184;349;613
00-2-01-04-2283;3;146;184;333;613
00-2-01-04-2284;7;150;179;336;613
00-2-01-04-2285;9;182;199;390;619
00-2-01-04-2286;8;147;148;303;554
00-2-01-04-2287;7;110;168;285;554
00-2-01-04-2288;6;115;151;272;554
00-2-01-04-2289;9;127;167;303;554
00-2-01-04-2290;3;106;170;279;554
00-2-01-04-2291;11;140;164;315;554
00-2-01-04-2292;10;114;173;297;554
00-2-01-04-2293;6;120;188;314;556
00-2-01-05-2294;2;163;203;368;602
00-2-01-05-2295;12;182;199;393;602
00-2-01-05-2296;6;153;222;381;602
00-2-01-05-2297;7;139;209;355;602
00-2-01-05-2298;8;129;211;348;602
00-2-01-05-2299;8;170;212;390;602
00-2-01-05-2300;13;126;236;375;602
00-2-01-05-2301;5;148;212;365;602
00-2-01-05-2302;9;137;229;375;608
00-2-01-05-2303;9;160;206;375;602
00-2-01-05-2304;14;101;229;344;602
00-2-01-05-2305;10;137;188;335;602
00-2-01-05-2306;7;126;208;341;604
00-2-01-05-2307;1;221;166;388;519
00-2-01-05-2308;6;171;155;332;519
00-2-01-05-2309;4;156;186;346;521
00-2-01-05-2310;6;164;166;336;528
00-2-01-05-2311;3;202;154;359;528
00-2-01-05-2312;10;190;166;366;528
00-2-01-05-2313;9;187;169;365;530
00-2-01-05-2314;7;108;219;334;604
00-2-01-05-2315;2;102;225;329;604
00-2-01-05-2316;3;116;213;332;604
00-2-01-05-2317;3;104;221;328;604
00-2-01-05-2318;10;118;209;337;606
00-2-01-05-2319;9;76;199;284;523
00-2-01-05-2320;5;75;201;281;523
00-2-01-05-2321;6;96;178;280;523
00-2-01-05-2322;5;85;208;298;523
00-2-01-05-2323;9;73;185;267;527
00-2-01-06-2324;5;138;175;318;518
00-2-01-06-2325;4;132;167;303;518
00-2-01-06-2326;7;105;183;295;518
00-2-01-06-2327;4;134;156;294;521
00-2-01-06-2328;5;126;178;309;558
00-2-01-06-2329;2;116;173;291;558
00-2-01-06-2330;10;149;148;307;558
00-2-01-06-2331;16;131;162;309;558
00-2-01-06-2332;7;116;172;295;558
00-2-01-06-2333;5;140;130;275;561
00-2-01-06-2334;8;119;154;281;520
00-2-01-06-2335;4;91;168;263;520
00-2-01-06-2336;5;106;169;280;521
00-2-01-06-2337;12;195;195;402;617
00-2-01-06-2338;10;171;182;363;617
00-2-01-06-2339;10;211;179;400;617
00-2-01-06-2340;16;183;194;393;617
00-2-01-06-2341;8;140;218;366;591
00-2-01-06-2342;10;148;207;365;591
00-2-01-06-2343;10;149;188;347;592
00-2-01-06-2344;6;64;108;178;335
00-2-01-06-2345;7;147;197;351;593
00-2-01-06-2346;10;133;220;363;594
00-2-01-07-2347;8;140;170;318;479
00-2-01-07-2348;4;113;169;286;479
00-2-01-07-2349;6;167;144;317;479
00-2-01-07-2350;7;127;200;334;550
00-2-01-07-2351;7;147;190;344;551
00-2-01-07-2352;4;112;193;309;572
00-2-01-07-2353;10;111;190;311;572
00-2-01-07-2354;8;143;112;263;457
00-2-01-07-2355;12;99;124;235;457
00-2-01-07-2356;6;111;113;230;409
00-2-01-07-2357;11;86;151;248;410
00-2-01-07-2358;0;49;122;171;328
00-2-01-07-2359;0;62;132;194;328
00-2-01-08-2360;8;159;197;364;602
00-2-01-08-2361;6;157;215;378;602
00-2-01-08-2362;11;181;207;399;602
00-2-01-08-2363;6;137;210;353;602
00-2-01-08-2364;6;153;232;391;602
00-2-01-08-2365;8;144;239;391;602
00-2-01-08-2366;3;131;163;297;602
00-2-01-08-2367;7;135;210;352;602
00-2-01-08-2368;6;146;186;338;602
00-2-01-08-2369;7;141;239;387;602
00-2-01-08-2370;8;184;247;439;602
00-2-01-08-2371;1;178;205;384;602
00-2-01-08-2372;9;172;203;384;608
00-2-01-08-2373;8;138;224;370;600
00-2-01-08-2374;7;154;223;384;600
00-2-01-08-2375;7;150;198;355;600
00-2-01-08-2376;4;146;217;367;600
00-2-01-08-2377;9;156;172;337;600
00-2-01-08-2378;5;154;186;345;600
00-2-01-08-2379;14;134;214;362;600
00-2-01-08-2380;10;169;176;355;600
00-2-01-08-2381;8;136;203;347;600
00-2-01-08-2382;4;118;250;372;600
00-2-01-08-2383;4;123;202;329;600
00-2-01-08-2384;9;154;184;347;600
00-2-01-08-2385;10;152;199;361;600
00-2-01-08-2386;9;149;210;368;600
00-2-01-08-2387;4;144;223;371;590
00-2-01-08-2388;10;162;185;357;590
00-2-01-08-2389;6;163;62;231;532
00-2-01-08-2390;4;89;24;117;447
00-2-01-08-2391;3;129;26;158;710
00-2-01-08-2392;1;58;15;74;310
00-2-01-08-2393;1;83;25;109;488
00-2-01-08-2394;1;68;17;86;508
00-2-01-08-2396;1;9;5;15;129
00-2-01-08-2397;0;43;13;56;356
00-2-01-08-2398;0;8;5;13;26
00-2-01-09-2400;3;164;194;361;568
00-2-01-09-2401;3;139;199;341;568
00-2-01-09-2402;3;172;180;355;568
00-2-01-09-2403;4;136;184;324;568
00-2-01-09-2404;4;160;205;369;568
00-2-01-09-2405;5;170;208;383;568
00-2-01-09-2406;8;140;198;346;570
00-2-01-09-2407;7;164;177;348;581
00-2-01-09-2408;5;156;167;328;581
00-2-01-09-2409;4;152;154;310;581
00-2-01-09-2410;9;156;176;341;583
00-2-01-09-2411;7;135;160;302;494
00-2-01-09-2412;5;128;179;312;495
00-2-01-09-2413;2;115;169;286;563
00-2-01-10-2415;11;188;192;391;610
00-2-01-10-2416;5;162;241;408;610
00-2-01-10-2417;7;155;211;373;610
00-2-01-10-2418;2;127;229;358;610
00-2-01-10-2419;10;153;227;390;610
00-2-01-10-2420;9;152;188;349;610
00-2-01-10-2421;6;153;209;368;610
00-2-01-10-2422;7;161;163;331;610
00-2-01-10-2423;14;167;193;374;610
00-2-01-10-2424;14;183;184;381;610
00-2-01-10-2425;6;140;215;361;610
00-2-01-10-2426;4;147;217;368;610
00-2-01-10-2427;9;135;199;343;610
00-2-01-10-2428;5;150;210;365;610
00-2-01-10-2429;6;167;208;381;610
00-2-01-10-2430;9;147;219;375;610
00-2-01-10-2431;4;152;200;356;610
00-2-01-10-2432;7;138;202;347;610
00-2-01-10-2433;5;175;190;370;615
00-2-01-10-2434;7;162;193;362;591
00-2-01-10-2435;9;156;197;362;591
00-2-01-10-2436;7;186;169;362;591
00-2-01-10-2437;6;140;186;332;591
00-2-01-10-2438;10;154;187;351;591
00-2-01-10-2439;5;154;182;341;591
00-2-01-10-2440;8;157;173;338;591
00-2-01-10-2441;11;146;179;336;591
00-2-01-10-2442;8;161;171;340;591
00-2-01-10-2443;11;159;166;336;591
00-2-01-10-2444;7;142;185;334;591
00-2-01-10-2445;11;152;165;328;591
00-2-01-10-2446;9;156;179;344;592
00-2-01-10-2447;5;140;140;285;493
00-2-01-10-2448;8;154;139;301;493
00-2-01-10-2449;7;144;154;305;495
00-2-01-11-2450;10;138;202;350;580
00-2-01-11-2451;5;118;210;333;580
00-2-01-11-2452;10;123;204;337;580
00-2-01-11-2453;9;138;197;344;580
00-2-01-11-2454;6;126;197;329;580
00-2-01-11-2455;4;132;227;363;580
00-2-01-11-2456;4;139;197;340;586
00-2-01-11-2457;4;93;193;290;492
00-2-01-11-2458;5;82;204;291;492
00-2-01-11-2459;2;100;143;245;404
00-2-01-11-2460;7;69;125;201;404
00-2-01-11-2461;1;79;88;168;262
00-2-01-12-2462;8;147;216;371;584
00-2-01-12-2463;6;147;176;329;584
00-2-01-12-2464;6;162;214;382;584
00-2-01-12-2465;9;147;210;366;587
00-2-01-12-2466;6;161;145;312;582
00-2-01-12-2467;6;114;140;260;582
00-2-01-12-2468;6;137;136;279;582
00-2-01-12-2469;4;117;162;283;582
00-2-01-12-2470;0;140;159;299;582
00-2-01-12-2472;9;118;167;294;583
00-2-01-12-2473;5;148;168;321;600
00-2-01-12-2474;4;150;182;336;600
00-2-01-12-2475;3;169;157;329;600
00-2-01-12-2476;6;118;159;283;572
00-2-01-12-2477;9;133;167;309;572
00-2-01-12-2478;4;122;156;282;468
00-2-01-12-2479;7;141;149;297;468
00-2-01-12-2480;6;136;154;296;468
00-2-01-13-2481;6;122;191;319;530
00-2-01-13-2482;10;137;160;307;530
00-2-01-13-2483;2;146;181;329;530
00-2-01-13-2484;2;137;157;296;530
00-2-01-13-2485;5;143;151;299;530
00-2-01-13-2487;10;121;182;313;530
00-2-01-13-2488;5;150;186;341;536
00-2-01-13-2489;5;176;146;327;536
00-2-01-13-2490;8;170;174;352;538
00-2-01-14-2491;5;120;94;219;397
00-2-01-14-2492;8;127;85;220;397
00-2-01-14-2493;5;141;176;322;492
00-2-01-14-2494;12;131;172;315;493
00-2-01-14-2495;0;26;33;59;86
00-2-01-14-2496;4;18;48;70;127
00-2-02-01-2497;12;145;218;375;588
00-2-02-01-2498;19;169;217;405;588
00-2-02-01-2499;16;165;214;395;588
00-2-02-01-2501;15;162;223;400;588
00-2-02-01-2502;21;158;214;393;588
00-2-02-01-2503;11;189;192;392;588
00-2-02-01-2504;13;150;220;383;588
00-2-02-01-2505;18;174;190;382;588
00-2-02-01-2506;13;152;205;370;588
00-2-02-01-2507;16;164;207;387;588
00-2-02-01-2508;12;186;204;402;588
00-2-02-01-2509;15;167;202;384;588
00-2-02-01-2510;13;152;217;382;588
00-2-02-01-2511;5;140;229;374;588
00-2-02-01-2512;11;147;210;368;588
00-2-02-01-2513;13;145;212;370;588
00-2-02-01-2514;11;138;217;366;588
00-2-02-01-2515;24;153;204;381;588
00-2-02-01-2516;11;171;189;371;600
00-2-02-02-2517;8;134;207;349;522
00-2-02-02-2518;13;111;192;316;522
00-2-02-02-2519;12;157;167;336;522
00-2-02-02-2520;9;112;221;342;522
00-2-02-02-2521;8;162;181;351;523
00-2-02-02-2522;9;109;156;274;427
00-2-02-02-2523;1;50;63;114;170
00-2-02-02-2524;1;91;121;213;346
00-2-02-02-2525;1;119;164;284;537
00-2-02-03-2526;18;135;241;394;600
00-2-02-03-2527;17;101;253;371;600
00-2-02-03-2528;13;129;247;389;600
00-2-02-03-2529;16;118;222;356;600
00-2-02-03-2530;12;113;222;347;600
00-2-02-03-2531;9;137;212;358;600
00-2-02-03-2532;19;136;215;370;600
00-2-02-03-2533;8;130;219;357;600
00-2-02-03-2534;13;169;204;386;600
00-2-02-03-2535;13;107;204;324;560
00-2-02-03-2536;18;112;201;331;559
00-2-02-03-2537;0;8;4;12;34
00-2-02-03-2538;5;100;189;294;549
00-2-02-03-2539;8;133;168;309;549
00-2-02-03-2540;12;0;1;13;549
00-2-02-03-2541;11;111;171;293;549
00-2-02-03-2542;8;127;180;315;549
00-2-02-03-2543;3;112;186;301;554
00-2-02-04-2544;5;93;169;267;415
00-2-02-04-2545;5;83;158;246;415
00-2-02-04-2546;5;70;197;272;417
00-2-02-04-2547;3;142;137;282;381
00-2-02-04-2548;13;114;214;341;571
00-2-02-04-2549;18;129;220;367;571
00-2-02-04-2550;6;129;202;337;571
00-2-02-04-2551;10;154;196;360;571
00-2-02-04-2552;5;138;210;353;571
00-2-02-04-2553;12;102;202;316;571
00-2-02-04-2554;8;74;152;234;412
00-2-02-04-2555;18;101;119;238;413
00-2-02-04-2556;4;120;136;260;328
00-2-02-04-2557;4;112;108;224;329
00-2-02-05-2558;9;122;167;298;443
00-2-02-05-2559;8;106;159;273;443
00-2-02-05-2560;13;97;190;300;443
00-2-02-05-2561;0;56;67;123;174
00-2-02-05-2562;2;38;84;124;199
00-2-02-05-2563;10;77;193;280;463
00-2-02-05-2564;4;104;161;269;463
00-2-02-05-2565;8;22;56;86;123
00-2-02-05-2566;2;26;62;90;143
00-2-02-05-2567;11;101;236;348;510
00-2-02-06-2568;11;149;255;415;600
00-2-02-06-2569;20;151;236;407;600
00-2-02-06-2570;12;137;236;385;600
00-2-02-06-2571;6;147;220;373;600
00-2-02-06-2572;12;159;215;386;600
00-2-02-06-2573;17;141;209;367;561
00-2-02-06-2574;11;138;201;350;560
00-2-02-06-2575;14;174;195;383;586
00-2-02-06-2576;11;107;183;301;554
00-2-02-06-2577;9;145;152;306;554
00-2-02-06-2578;12;136;169;317;554
00-2-02-06-2579;11;101;186;298;554
00-2-02-06-2580;4;121;212;337;494
00-2-02-07-2581;9;144;160;313;530
00-2-02-07-2582;5;124;213;342;530
00-2-02-07-2583;17;147;195;359;530
00-2-02-07-2584;13;114;224;351;533
00-2-02-07-2585;8;102;139;249;439
00-2-02-07-2586;3;92;135;230;439
00-2-02-07-2587;2;82;162;246;441
00-2-02-08-2588;10;123;235;368;544
00-2-02-08-2589;7;132;195;334;545
00-2-02-08-2590;7;67;264;338;505
00-2-02-08-2591;9;123;208;340;569
00-2-02-08-2592;12;106;197;315;569
00-2-02-08-2593;16;133;185;334;569
00-2-02-08-2594;8;102;220;330;572
00-2-02-08-2595;1;15;20;36;94
00-2-02-09-2596;13;129;225;367;603
00-2-02-09-2597;12;125;221;358;603
00-2-02-09-2598;16;109;217;342;603
00-2-02-09-2599;16;137;208;361;603
00-2-02-09-2600;11;137;209;357;603
00-2-02-09-2601;12;117;225;354;604
00-2-02-09-2602;9;103;150;262;466
00-2-02-09-2603;15;122;143;280;467
00-2-02-10-2604;8;127;168;303;537
00-2-02-10-2605;10;109;195;314;537
00-2-02-10-2606;15;119;197;331;537
00-2-02-10-2607;5;104;162;271;401
00-2-02-11-2608;16;113;167;296;506
00-2-02-11-2609;15;139;170;324;506
00-2-02-11-2610;7;138;173;318;506
00-2-02-11-2611;11;123;169;303;509
00-2-02-12-2612;0;40;65;105;156
00-2-02-12-2613;2;22;36;60;103
00-2-02-12-2614;0;9;9;18;41
00-2-02-13-2615;4;104;171;279;458
00-2-02-13-2616;7;106;147;260;458
00-2-02-13-2617;6;106;172;284;458
00-2-02-13-2618;8;136;178;322;561
00-2-02-13-2619;14;119;182;315;561
00-2-02-13-2620;6;153;153;312;561
00-2-02-13-2621;5;125;185;315;564
00-2-02-13-2622;6;65;131;202;348
00-2-02-13-2623;5;67;156;228;348
00-2-02-13-2624;2;98;126;226;376
00-2-02-13-2625;2;91;127;220;376
00-2-02-13-2626;5;24;122;151;241
00-2-02-13-2627;9;82;147;238;383
00-2-02-13-2628;4;68;139;211;384
00-2-02-14-2629;0;13;12;25;40
00-2-02-14-2630;13;86;199;298;482
00-2-02-14-2631;5;75;154;234;482
00-2-02-14-2632;7;69;208;284;484
00-2-02-14-2633;9;117;230;356;520
00-2-02-14-2634;6;76;260;342;570
00-2-02-14-2635;1;108;244;353;571
00-2-03-01-2636;6;155;264;425;605
00-2-03-01-2637;12;225;183;420;605
00-2-03-01-2638;6;177;219;402;605
00-2-03-01-2639;11;188;224;423;605
00-2-03-01-2640;3;175;217;395;605
00-2-03-01-2641;4;209;189;402;605
00-2-03-01-2642;6;159;219;384;605
00-2-03-01-2643;7;172;221;400;605
00-2-03-01-2644;14;193;220;427;605
00-2-03-01-2645;11;171;217;399;605
00-2-03-01-2646;10;139;225;374;605
00-2-03-01-2647;9;174;214;397;605
00-2-03-01-2648;8;171;207;386;605
00-2-03-01-2649;5;166;218;389;605
00-2-03-01-2650;7;189;196;392;605
00-2-03-01-2651;10;144;243;397;605
00-2-03-01-2652;13;179;194;386;605
00-2-03-01-2653;11;194;193;398;605
00-2-03-01-2654;7;170;211;388;605
00-2-03-01-2655;7;212;199;418;614
00-2-03-01-2656;10;137;181;328;518
00-2-03-01-2657;4;131;192;327;518
00-2-03-01-2658;5;125;161;291;518
00-2-03-01-2659;4;125;193;322;518
00-2-03-01-2660;8;137;187;332;519
00-2-03-01-2661;3;76;86;165;366
00-2-03-01-2662;9;68;121;198;366
00-2-03-02-2663;11;166;202;379;591
00-2-03-02-2664;9;133;225;367;591
00-2-03-02-2665;6;164;194;364;592
00-2-03-02-2667;6;83;120;209;344
00-2-03-02-2668;4;88;134;226;378
00-2-03-02-2669;10;98;135;243;379
00-2-03-02-2670;7;129;179;315;481
00-2-03-02-2671;5;138;184;327;481
00-2-03-02-2672;8;135;163;306;483
00-2-03-03-2673;16;176;187;379;500
00-2-03-03-2674;9;169;172;350;500
00-2-03-03-2675;9;177;157;343;500
00-2-03-03-2676;8;173;180;361;503
00-2-03-03-2677;7;147;243;397;588
00-2-03-03-2678;8;194;211;413;588
00-2-03-03-2679;12;168;213;393;589
00-2-03-03-2680;11;137;158;306;475
00-2-03-03-2681;5;97;143;245;475
00-2-03-03-2682;8;119;153;280;477
00-2-03-03-2683;11;149;226;386;599
00-2-03-03-2684;2;85;112;199;320
00-2-03-03-2685;6;98;124;228;320
00-2-03-04-2688;7;151;237;395;579
00-2-03-04-2689;9;156;239;404;579
00-2-03-04-2690;6;149;239;394;579
00-2-03-04-2692;5;187;247;439;579
00-2-03-04-2693;5;159;277;441;579
00-2-03-04-2694;12;158;237;407;583
00-2-03-04-2695;4;102;147;253;315
00-2-03-04-2696;5;85;133;223;316
00-2-03-04-2697;13;168;221;402;599
00-2-03-04-2698;11;152;216;379;599
00-2-03-04-2699;5;144;209;358;599
00-2-03-04-2700;10;164;216;390;601
00-2-03-04-2701;4;153;205;362;499
00-2-03-04-2702;5;178;185;368;500
00-2-03-04-2704;8;109;175;292;428
00-2-03-04-2705;7;128;158;293;428
00-2-03-04-2706;2;6;23;31;89
00-2-03-05-2707;15;140;191;346;540
00-2-03-05-2708;9;134;162;305;540
00-2-03-05-2709;5;164;166;335;540
00-2-03-05-2710;6;131;192;329;540
00-2-03-05-2711;7;119;190;316;540
00-2-03-05-2712;6;133;111;250;404
00-2-03-05-2713;4;105;111;220;404
00-2-03-05-2714;5;118;134;257;405
00-2-03-05-2715;11;149;168;328;507
00-2-03-05-2716;1;121;157;279;507
00-2-03-05-2717;11;133;162;306;507
00-2-03-05-2718;13;129;145;287;510
00-2-03-07-2719;8;148;192;348;512
00-2-03-07-2720;10;123;183;316;512
00-2-03-07-2721;15;123;195;333;512
00-2-03-07-2722;9;130;204;343;515
00-2-03-07-2723;6;157;134;297;431
00-2-03-07-2724;5;139;164;308;431
00-2-03-07-2725;4;114;152;270;431
00-2-03-07-2726;6;150;173;329;517
00-2-03-07-2727;10;112;196;318;517
00-2-03-07-2728;8;110;143;261;517
00-2-03-07-2729;9;111;198;318;519
00-2-03-07-2730;5;118;162;285;453
00-2-03-07-2731;3;100;179;282;453
00-2-03-07-2732;10;124;172;306;455
00-2-03-07-2733;3;76;109;188;346
00-2-03-07-2734;12;108;130;250;435
00-2-03-07-2735;14;117;113;244;435
00-2-03-07-2736;12;109;148;269;435
00-2-03-08-2737;7;133;224;364;532
00-2-03-08-2738;5;128;200;333;532
00-2-03-08-2739;17;137;194;348;532
00-2-03-08-2740;3;139;217;359;532
00-2-03-08-2741;10;142;180;332;535
00-2-03-08-2742;8;126;190;324;528
00-2-03-08-2743;7;125;157;289;528
00-2-03-08-2744;5;156;166;327;529
00-2-03-08-2745;4;62;195;261;388
00-2-03-08-2746;6;59;168;233;389
00-2-03-08-2747;2;87;177;266;388
00-2-03-08-2748;5;84;150;239;389
00-2-03-08-2749;4;68;85;157;292
00-2-04-01-2750;7;161;168;336;576
00-2-04-01-2751;4;190;163;357;576
00-2-04-01-2752;1;166;170;337;576
00-2-04-01-2753;2;60;117;179;304
00-2-04-01-2754;2;79;119;200;305
00-2-04-01-2755;1;28;23;52;118
00-2-04-01-2756;0;7;31;38;71
00-2-04-02-2757;4;120;143;267;434
00-2-04-02-2758;1;16;21;38;79
00-2-04-03-2759;2;155;120;277;443
00-2-04-03-2760;5;159;133;297;443
00-2-04-04-2761;2;150;143;295;541
00-2-04-04-2762;6;132;158;296;541
00-2-05-01-2763;9;172;200;381;601
00-2-05-01-2764;10;163;215;388;601
00-2-05-01-2765;4;170;225;399;601
00-2-05-01-2766;10;221;190;421;601
00-2-05-01-2767;7;183;191;381;601
00-2-05-01-2768;12;191;214;417;601
00-2-05-01-2769;11;204;197;412;601
00-2-05-01-2770;8;208;202;418;606
00-2-05-01-2771;7;180;214;401;589
00-2-05-01-2772;6;154;235;395;589
00-2-05-01-2773;11;151;224;386;589
00-2-05-01-2774;11;170;192;373;589
00-2-05-01-2775;0;7;8;15;46
00-2-05-02-2776;5;156;155;316;467
00-2-05-02-2777;7;129;172;308;467
00-2-05-02-2778;8;140;143;291;467
00-2-05-02-2779;4;148;151;303;468
00-2-05-02-2781;4;193;199;396;600
00-2-05-02-2782;1;46;65;112;176
00-2-05-03-2783;11;99;199;309;495
00-2-05-03-2784;7;94;188;289;495
00-2-05-03-2785;5;111;185;301;495
00-2-05-03-2786;11;100;174;285;495
00-2-05-03-2787;5;97;192;294;496
00-2-05-04-2788;6;66;147;219;326
00-2-05-04-2789;2;84;126;212;327
00-2-05-04-2790;8;61;209;278;464
00-2-05-04-2791;8;80;179;267;465
00-2-05-04-2792;4;84;131;219;356
00-2-05-04-2793;6;94;123;223;356
00-2-05-05-2794;6;177;179;362;568
00-2-05-05-2795;9;162;199;370;568
00-2-05-05-2796;9;169;181;359;568
00-2-05-05-2797;5;188;181;374;569
00-2-05-05-2798;2;93;120;215;335
00-2-05-05-2799;1;93;121;215;335
00-2-05-06-2800;3;100;193;296;439
00-2-05-06-2801;3;98;161;262;439
00-2-05-06-2802;4;106;130;240;439
00-2-05-07-2803;7;142;201;350;580
00-2-05-07-2804;2;105;184;291;580
00-2-05-07-2805;8;100;209;317;581
00-2-05-08-2806;18;137;175;330;542
00-2-05-08-2807;1;41;23;65;113
00-2-06-01-2808;10;169;179;358;580
00-2-06-01-2809;10;175;190;375;580
00-2-06-01-2810;8;156;204;368;580
00-2-06-01-2812;11;168;177;356;580
00-2-06-01-2813;13;149;176;338;580
00-2-06-01-2814;14;118;215;347;580
00-2-06-01-2815;12;130;184;326;580
00-2-06-01-2816;15;151;210;376;580
00-2-06-01-2817;12;175;194;381;580
00-2-06-01-2818;14;175;185;374;580
00-2-06-01-2819;6;163;209;378;580
00-2-06-01-2820;9;175;185;369;580
00-2-06-01-2821;13;177;193;383;590
00-2-06-01-2822;8;145;197;350;571
00-2-06-01-2823;13;154;195;362;571
00-2-06-01-2824;6;151;191;348;571
00-2-06-01-2825;12;137;193;342;571
00-2-06-01-2826;7;94;169;270;439
00-2-06-01-2827;11;132;141;284;439
00-2-06-01-2828;13;167;173;353;583
00-2-06-01-2829;11;142;189;342;583
00-2-06-01-2830;5;141;207;353;583
00-2-06-01-2831;0;8;7;15;54
00-2-06-02-2832;6;161;190;357;619
00-2-06-02-2833;10;148;203;361;619
00-2-06-02-2834;9;193;197;399;619
00-2-06-02-2835;9;145;200;354;619
00-2-06-02-2836;1;98;132;231;358
00-2-06-03-2837;10;134;135;279;417
00-2-06-03-2838;6;115;146;267;417
00-2-06-03-2839;9;121;158;288;419
00-2-06-03-2840;1;185;115;301;383
00-2-06-03-2841;12;108;209;329;434
00-2-06-03-2842;8;74;103;185;296
00-2-06-04-2843;15;112;189;316;512
00-2-06-04-2844;8;147;167;322;512
00-2-06-04-2845;12;134;145;291;512
00-2-06-04-2846;5;118;183;306;512
00-2-06-04-2847;14;144;202;360;488
00-2-06-04-2848;2;107;226;335;488
00-2-06-04-2849;8;93;116;217;302
00-2-06-04-2850;1;68;123;192;303
00-2-06-05-2851;8;132;187;327;549
00-2-06-05-2852;13;129;160;302;549
00-2-06-05-2853;7;123;178;308;549
00-2-06-05-2854;11;160;196;367;552
00-2-06-05-2855;3;123;99;225;350
00-2-06-06-2856;2;173;166;341;485
00-2-06-06-2857;6;195;157;358;486
00-2-06-06-2858;8;131;199;338;524
00-2-06-06-2859;10;130;159;299;524
00-2-06-06-2860;10;153;171;334;524
00-2-06-07-2861;3;182;196;381;564
00-2-06-07-2862;7;129;202;338;564
00-2-06-07-2863;6;177;170;353;564
00-2-06-07-2864;11;174;183;368;564
00-2-06-07-2865;9;190;149;348;564
00-2-06-07-2866;3;48;49;100;143
00-2-06-08-2867;3;100;156;259;447
00-2-06-08-2868;4;109;172;285;447
00-2-06-08-2869;3;111;169;283;448
00-2-06-08-2870;10;136;178;324;533
00-2-06-08-2871;10;136;201;347;533
00-2-06-08-2872;14;115;192;321;535
00-2-06-08-2873;12;174;190;376;609
00-2-07-01-2874;8;212;195;415;601
00-2-07-01-2875;8;197;203;408;601
00-2-07-01-2876;10;204;207;421;601
00-2-07-01-2877;16;165;191;372;601
00-2-07-01-2878;5;172;216;393;601
00-2-07-01-2879;13;208;191;412;601
00-2-07-01-2880;15;188;187;390;601
00-2-07-01-2881;12;199;213;424;606
00-2-07-02-2882;13;164;182;359;512
00-2-07-02-2883;4;161;151;316;512
00-2-07-02-2884;5;137;171;313;512
00-2-07-02-2885;13;165;165;343;512
00-2-07-02-2886;6;181;179;366;516
00-2-07-02-2887;14;131;180;325;535
00-2-07-02-2888;9;133;209;351;535
00-2-07-02-2889;10;156;199;365;535
00-2-07-02-2890;10;147;213;370;535
00-2-07-02-2891;8;151;190;349;535
00-2-07-02-2892;9;169;213;391;540
00-2-07-02-2893;6;135;202;343;552
00-2-07-02-2894;13;149;200;362;553
00-2-07-02-2895;4;162;204;370;577
00-2-07-02-2896;14;162;192;368;577
00-2-07-03-2897;11;162;187;360;560
00-2-07-03-2898;13;170;173;356;560
00-2-07-03-2899;9;178;184;371;560
00-2-07-03-2900;4;133;193;330;560
00-2-07-03-2901;12;169;195;376;560
00-2-07-03-2902;9;146;187;342;560
00-2-07-03-2903;6;184;185;375;560
00-2-07-03-2905;8;163;169;340;560
00-2-07-03-2906;11;165;179;355;567
00-2-07-04-2907;7;124;138;269;472
00-2-07-04-2908;9;96;165;270;472
00-2-07-04-2909;10;141;140;291;472
00-2-07-04-2910;6;116;176;298;474
00-2-07-05-2911;6;120;170;296;543
00-2-07-05-2912;7;140;166;313;543
00-2-07-05-2913;8;124;170;302;543
00-2-07-06-2914;13;114;192;319;558
00-2-07-06-2915;10;123;176;309;558
00-2-07-06-2916;14;125;188;327;558
00-2-07-06-2917;7;157;158;322;558
00-2-07-06-2918;10;141;158;309;558
00-2-07-06-2919;4;168;158;330;558
00-2-07-06-2920;12;162;182;356;558
00-2-07-06-2921;12;157;171;340;558
00-2-07-06-2922;8;127;172;307;558
00-2-07-07-2923;7;164;234;405;611
00-2-07-07-2924;8;187;238;433;611
00-2-07-07-2925;16;169;240;425;611
00-2-07-07-2926;13;192;207;412;611
00-2-07-07-2927;5;196;231;432;613
00-2-07-07-2928;0;22;9;31;57
00-2-08-01-2929;7;179;194;380;591
00-2-08-01-2930;7;172;223;402;591
00-2-08-01-2931;8;161;220;389;591
00-2-08-01-2932;11;169;178;358;591
00-2-08-01-2933;9;176;196;381;591
00-2-08-01-2934;7;171;221;399;591
00-2-08-01-2935;6;163;226;395;591
00-2-08-01-2936;7;225;216;448;591
00-2-08-01-2937;11;171;203;385;591
00-2-08-01-2938;11;179;239;429;591
00-2-08-01-2939;8;203;202;413;591
00-2-08-01-2940;10;184;211;405;594
00-2-08-01-2941;4;113;127;244;406
00-2-08-01-2942;1;91;153;245;407
00-2-08-02-2943;8;129;169;306;475
00-2-08-02-2944;8;150;137;295;475
00-2-08-02-2945;7;137;155;299;475
00-2-08-02-2946;7;148;169;324;476
00-2-08-02-2947;5;94;162;261;382
00-2-08-02-2948;7;123;112;242;382
00-2-08-03-2949;10;221;205;436;606
00-2-08-03-2950;5;245;200;450;606
00-2-08-03-2951;4;229;184;417;606
00-2-08-03-2952;8;195;230;433;609
00-2-08-03-2953;6;110;97;213;339
00-2-08-03-2954;6;116;128;250;339
00-2-08-03-2955;8;113;157;278;449
00-2-08-03-2956;11;149;140;300;450
00-2-08-04-2957;5;141;186;332;580
00-2-08-04-2958;3;148;166;317;580
00-2-08-04-2959;11;122;197;330;580
00-2-08-04-2960;8;144;188;340;580
00-2-08-04-2961;6;143;166;315;580
00-2-08-04-2962;8;142;183;333;580
00-2-08-04-2963;6;143;148;297;580
00-2-08-04-2964;11;159;173;343;584
00-2-08-04-2965;5;186;196;387;594
00-2-08-04-2966;12;162;203;377;594
00-2-08-04-2967;6;153;213;372;594
00-2-08-04-2968;8;228;181;417;595
00-2-08-05-2969;1;122;154;277;504
00-2-08-05-2970;10;121;126;257;504
00-2-08-05-2971;3;131;120;254;504
00-2-08-05-2972;5;164;143;312;506
00-2-09-01-2973;7;165;174;346;611
00-2-09-01-2974;6;159;185;350;611
00-2-09-01-2975;5;148;163;316;611
00-2-09-01-2976;6;163;156;325;611
00-2-09-01-2977;3;195;141;339;611
00-2-09-01-2978;6;151;174;331;611
00-2-09-01-2979;8;144;179;331;611
00-2-09-01-2980;6;153;171;330;611
00-2-09-01-2981;8;124;176;308;611
00-2-09-01-2982;8;170;169;347;611
00-2-09-01-2983;5;149;167;321;611
00-2-09-01-2985;4;155;141;300;538
00-2-09-01-2986;7;142;170;319;538
00-2-09-01-2987;0;9;5;14;33
00-2-09-02-2988;4;130;170;304;564
00-2-09-02-2990;3;113;151;267;566
00-2-09-03-2991;6;119;164;289;496
00-2-09-03-2992;5;114;143;262;497
00-2-09-04-2993;3;76;159;238;526
00-2-09-04-2994;3;101;145;249;526
00-2-09-04-2995;3;99;121;223;526
00-2-09-04-2996;3;84;136;223;526
00-2-09-04-2997;4;85;107;196;513
00-2-09-04-2998;7;103;84;194;513
00-2-09-04-2999;3;98;107;208;513
00-2-09-04-3000;2;102;96;200;515
00-2-09-04-3001;1;48;51;100;226
00-2-09-05-3002;1;69;113;183;304
00-2-09-05-3003;1;69;77;147;306
00-2-09-05-3004;1;67;106;174;347
00-2-09-05-3005;1;67;96;164;347
00-2-10-01-3006;8;185;202;395;600
00-2-10-01-3007;5;199;195;399;600
00-2-10-01-3008;8;179;201;388;600
00-2-10-01-3009;4;183;189;376;600
00-2-10-01-3010;10;213;173;396;600
00-2-10-01-3011;8;170;196;374;600
00-2-10-01-3012;8;170;196;374;600
00-2-10-01-3013;10;188;189;387;600
00-2-10-01-3014;9;179;215;403;600
00-2-10-01-3015;7;191;225;423;600
00-2-10-01-3016;5;177;198;380;556
00-2-10-01-3017;7;209;152;368;556
00-2-10-01-3018;10;131;161;302;483
00-2-10-01-3019;10;97;188;295;483
00-2-10-01-3020;5;144;139;288;428
00-2-10-01-3021;6;134;148;288;428
00-2-10-01-3022;9;145;157;311;429
00-2-10-01-3023;8;87;113;208;289
00-2-10-01-3024;5;100;157;262;397
00-2-10-01-3025;6;120;119;245;398
00-2-10-01-3026;7;108;171;286;489
00-2-10-01-3027;5;128;156;289;489
00-2-10-01-3028;10;94;175;279;489
00-2-10-01-3029;5;119;168;292;492
00-2-10-01-3030;10;212;159;381;516
00-2-10-01-3031;5;185;176;366;516
00-2-10-01-3032;10;125;187;322;535
00-2-10-01-3033;7;134;179;320;535
00-2-10-01-3034;10;131;172;313;535
00-2-10-01-3035;8;114;194;316;535
00-2-10-01-3036;4;121;203;328;535
00-2-10-01-3037;6;123;206;335;535
00-2-10-01-3038;11;121;198;330;539
00-2-10-01-3039;1;36;40;77;131
00-2-10-01-3040;15;177;170;362;555
00-2-10-01-3041;8;172;176;356;555
00-2-10-01-3042;6;160;199;365;555
00-2-10-01-3043;12;171;171;354;555
00-2-10-01-3044;10;175;181;366;555
00-2-10-01-3045;15;171;209;395;555
00-2-10-01-3046;6;183;177;366;558
00-2-10-01-3047;9;94;116;219;355
00-2-10-01-3048;6;61;142;209;355
00-2-10-01-3049;12;193;217;422;605
00-2-10-01-3050;7;176;222;405;605
00-2-10-01-3051;6;175;208;389;605
00-2-10-01-3052;5;179;185;369;605
00-2-10-01-3053;7;176;190;373;605
00-2-10-01-3054;11;157;198;366;605
00-2-10-01-3055;7;188;204;399;605
00-2-10-01-3056;5;221;199;425;605
00-2-10-01-3057;8;190;193;391;605
00-2-10-01-3058;4;199;195;398;606
00-2-10-01-3059;2;13;7;22;46
00-2-10-01-3060;2;78;163;243;412
00-2-10-01-3061;5;88;141;234;412
00-2-10-01-3062;7;83;142;232;413
00-2-10-01-3063;2;27;45;74;109
00-2-10-01-3064;6;156;222;384;569
00-2-10-01-3065;2;166;187;355;569
00-2-10-01-3066;6;156;203;365;569
00-2-10-01-3067;8;143;229;380;571
00-2-10-01-3068;6;165;187;358;518
00-2-10-01-3069;9;177;176;362;518
00-2-10-01-3070;8;154;196;358;518
00-2-10-01-3071;11;178;170;359;518
00-2-10-01-3072;7;168;211;386;518
00-2-10-01-3073;12;146;204;362;521
00-2-10-01-3074;8;79;139;226;377
00-2-10-02-3075;8;144;246;398;602
00-2-10-02-3076;6;152;195;353;602
00-2-10-02-3077;9;149;204;362;602
00-2-10-02-3078;4;130;227;361;602
00-2-10-02-3079;13;153;221;387;602
00-2-10-02-3080;5;146;209;360;605
00-2-10-02-3081;3;72;98;173;277
00-2-10-02-3082;3;128;177;308;512
00-2-10-02-3083;2;124;156;282;513
00-2-10-02-3084;7;152;216;375;575
00-2-10-02-3085;7;146;194;347;575
00-2-10-02-3086;10;169;175;354;575
00-2-10-02-3087;11;133;200;344;578
00-2-10-02-3088;6;116;147;269;423
00-2-10-02-3089;5;99;144;248;423
00-2-10-02-3090;5;83;135;223;423
00-2-10-02-3091;7;89;157;253;414
00-2-10-02-3092;5;88;144;237;414
00-2-10-02-3093;6;121;123;250;416
00-2-10-02-3094;6;34;66;106;162
00-2-10-02-3095;1;68;60;129;171
00-2-10-02-3096;12;107;188;307;470
00-2-10-02-3097;7;69;211;287;464
00-2-10-02-3098;5;105;140;250;393
00-2-10-02-3099;3;84;147;234;393
00-2-10-03-3100;3;122;97;222;321
00-2-10-04-3101;7;144;238;389;609
00-2-10-04-3102;10;159;203;372;609
00-2-10-04-3103;8;166;208;382;609
00-2-10-04-3104;9;157;227;393;609
00-2-10-04-3105;7;140;214;361;609
00-2-10-04-3106;10;155;230;395;609
00-2-10-04-3107;7;139;201;347;609
00-2-10-04-3108;9;126;196;331;609
00-2-10-04-3109;8;139;229;376;609
00-2-10-04-3110;8;154;216;378;609
00-2-10-04-3111;11;142;216;369;609
00-2-10-04-3112;6;122;218;346;609
00-2-10-04-3113;9;111;229;349;609
00-2-10-04-3114;9;132;256;397;616
00-2-10-04-3115;2;94;161;257;467
00-2-10-04-3116;5;112;153;270;467
00-2-10-04-3117;2;80;198;280;467
00-2-10-04-3118;3;124;182;309;469
00-2-10-04-3119;5;103;83;191;341
00-2-10-04-3120;4;76;96;176;341
00-2-10-04-3121;2;105;118;225;376
00-2-10-04-3122;4;90;126;220;377
00-2-10-04-3123;3;115;174;292;441
00-2-10-04-3124;4;101;98;203;334
00-2-10-04-3125;5;71;105;181;335
00-2-10-04-3126;7;137;139;283;463
00-2-10-04-3127;10;104;169;283;463
00-2-10-04-3128;9;108;176;293;463
00-2-10-04-3129;7;88;132;227;430
00-2-10-04-3130;2;98;127;227;431
00-2-10-05-3131;4;124;152;280;452
00-2-10-05-3132;2;131;168;301;452
00-2-10-05-3133;7;178;184;369;567
00-2-10-05-3134;4;168;198;370;567
00-2-10-05-3135;5;149;197;351;567
00-2-10-05-3136;8;157;186;351;567
00-2-10-05-3137;11;147;201;359;567
00-2-10-05-3138;5;185;187;377;567
00-2-10-05-3139;8;148;209;365;571
00-2-10-05-3140;5;99;152;256;427
00-2-10-05-3141;7;127;166;300;428
00-2-10-05-3142;7;142;214;363;530
00-2-10-05-3143;7;132;216;355;530
00-2-10-06-3144;8;123;246;377;600
00-2-10-06-3145;3;124;212;339;600
00-2-10-06-3146;7;127;186;320;600
00-2-10-06-3147;5;115;179;299;600
00-2-10-06-3148;6;109;223;338;600
00-2-10-06-3149;3;107;209;319;600
00-2-10-06-3150;7;127;202;336;600
00-2-10-06-3151;5;174;231;410;600
00-2-10-06-3152;5;134;181;320;600
00-2-10-06-3153;9;140;220;369;599
00-2-10-06-3154;4;85;172;261;442
00-2-10-06-3155;3;85;148;236;442
00-2-10-06-3156;9;102;158;269;443
00-2-10-06-3157;2;77;87;166;324
00-2-10-06-3158;2;98;90;190;325
00-2-10-06-3159;1;54;130;185;296
00-2-10-06-3160;5;74;55;134;311
00-2-10-06-3162;6;132;248;386;579
00-2-10-06-3163;1;60;92;153;232
00-2-10-06-3164;4;99;106;209;345
00-2-10-07-3165;10;132;201;343;610
00-2-10-07-3166;0;117;228;345;610
00-2-10-07-3167;4;116;235;355;610
00-2-10-07-3168;6;115;213;334;610
00-2-10-07-3169;4;113;233;350;610
00-2-10-07-3170;1;119;233;353;610
00-2-10-07-3171;8;122;214;344;610
00-2-10-07-3172;9;113;233;355;610
00-2-10-07-3173;7;127;235;369;612
00-2-10-07-3174;7;107;185;299;454
00-2-10-07-3175;5;88;160;253;454
00-2-10-07-3176;4;98;190;292;454
00-2-10-07-3177;2;34;44;80;124
00-2-10-07-3178;0;37;51;88;140
00-2-10-07-3179;7;137;175;319;566
00-2-10-07-3180;5;122;185;312;566
00-2-10-07-3181;7;90;208;305;566
00-2-10-07-3182;3;107;211;321;566
00-2-10-07-3183;7;154;166;327;568
00-2-10-07-3184;10;129;226;365;606
00-2-10-07-3185;7;130;236;373;607
00-2-10-08-3186;7;124;212;343;553
00-2-10-08-3187;8;121;203;332;553
00-2-10-08-3188;9;132;220;361;555
00-2-10-08-3189;7;104;220;331;484
00-2-10-08-3190;1;92;234;327;485
00-2-10-08-3191;4;97;209;310;476
00-2-10-08-3192;7;95;179;281;476
00-2-10-08-3193;6;99;200;305;476
00-2-10-08-3194;13;85;204;302;476
00-2-10-08-3195;5;38;69;112;150
00-2-10-09-3196;11;172;176;359;507
00-2-10-09-3197;9;146;180;335;507
00-2-10-09-3198;12;104;217;333;488
00-2-10-09-3199;5;147;169;321;488
00-2-10-09-3200;3;123;173;299;488
00-2-10-09-3201;3;131;133;267;413
00-2-10-09-3202;8;114;157;279;414
00-2-10-09-3203;1;66;37;104;436
00-2-10-09-3204;10;106;164;280;427
00-2-10-09-3205;8;105;163;276;428
00-2-10-09-3206;5;45;103;153;197
00-2-10-10-3207;2;122;99;223;359
00-2-10-10-3208;3;109;114;226;359
00-2-10-10-3209;4;108;138;250;398
00-2-10-11-3210;5;146;186;337;602
00-2-10-11-3211;8;122;182;312;602
00-2-10-11-3212;6;104;168;278;602
00-2-10-11-3213;4;140;197;341;605
00-2-10-11-3214;1;32;41;74;169
00-2-10-11-3215;4;81;100;185;263
00-2-10-11-3216;2;155;130;287;428
00-2-10-11-3217;3;46;87;136;261
00-2-10-11-3218;7;63;77;147;226
00-2-10-11-3219;6;83;101;190;332
00-2-10-11-3220;4;70;104;178;332
00-2-10-11-3221;2;43;63;108;214
00-2-10-11-3222;9;77;173;259;463
00-2-10-11-3223;3;35;74;112;193
00-2-10-11-3224;3;28;62;93;155
00-2-10-12-3225;9;140;180;329;570
00-2-10-12-3226;7;145;222;374;570
00-2-10-12-3227;15;177;166;358;572
00-2-10-12-3228;0;44;16;60;91
00-2-10-12-3229;1;79;63;143;289
00-2-10-12-3230;3;43;55;101;153
00-2-10-12-3231;3;32;42;77;105
00-2-10-13-3232;4;127;153;284;557
00-2-10-13-3233;3;111;134;248;462
00-2-10-13-3234;3;81;41;125;344
00-2-10-13-3235;7;110;192;309;558
00-2-10-13-3236;3;114;189;306;558
00-2-10-13-3237;3;92;161;256;558
00-2-10-13-3238;3;92;174;269;558
00-2-10-13-3239;5;73;203;281;558
00-2-10-13-3240;4;113;146;263;558
00-2-10-13-3241;4;118;205;327;558
00-2-10-13-3242;4;125;181;310;558
00-2-10-13-3243;14;116;180;310;561
00-2-10-13-3244;0;24;34;58;101
00-2-10-13-3245;3;62;99;164;298
00-2-10-13-3246;5;91;154;250;476
00-2-10-13-3247;1;53;76;130;209
00-2-10-13-3248;1;51;39;91;237
00-2-10-13-3249;2;54;55;111;203
00-2-10-13-3250;5;58;85;148;249
00-2-10-13-3251;2;32;75;109;318
00-2-10-13-3252;1;43;138;182;324
00-2-10-13-3253;3;17;31;51;102
00-2-10-13-3254;4;70;139;213;388
00-2-11-01-3255;6;186;208;400;539
00-2-11-01-3256;16;200;179;395;539
00-2-11-01-3257;6;226;157;389;539
00-2-11-01-3258;14;190;169;373;539
00-2-11-01-3259;9;187;214;410;539
00-2-11-01-3260;10;191;193;394;539
00-2-11-01-3261;14;166;223;403;543
00-2-11-01-3262;1;11;4;16;30
00-2-11-02-3263;6;142;130;278;410
00-2-11-02-3264;10;120;146;276;410
00-2-11-02-3265;10;196;107;313;411
00-2-11-03-3266;12;193;161;366;495
00-2-11-03-3267;7;213;167;387;495
00-2-11-04-3268;5;47;34;86;151
00-2-11-04-3269;9;104;138;251;341
00-2-11-04-3270;0;44;11;55;70
00-2-11-05-3271;11;251;136;398;559
00-2-11-05-3272;8;203;140;351;476
00-2-11-06-3273;4;154;52;210;289
00-2-11-06-3274;5;69;46;120;158
00-2-11-07-3275;6;268;118;392;492
00-2-11-07-3276;10;230;143;383;493
00-2-11-07-3277;3;193;101;297;365
00-2-12-01-3278;20;143;204;367;559
00-2-12-01-3279;9;149;184;342;559
00-2-12-01-3280;13;120;177;310;559
00-2-12-01-3281;7;128;188;323;559
00-2-12-01-3282;15;125;179;319;559
00-2-12-01-3283;16;137;170;323;559
00-2-12-01-3284;12;119;162;293;559
00-2-12-01-3285;13;126;200;339;559
00-2-12-01-3286;3;125;199;327;559
00-2-12-01-3287;15;134;170;319;567
00-2-12-01-3288;5;27;56;88;176
00-2-12-01-3289;3;108;134;245;418
00-2-12-01-3290;4;81;141;226;418
00-2-12-02-3291;3;127;210;340;580
00-2-12-02-3292;7;139;173;319;580
00-2-12-02-3293;6;120;208;334;580
00-2-12-02-3294;10;114;169;293;580
00-2-12-02-3295;7;112;196;315;580
00-2-12-02-3296;8;138;182;328;580
00-2-12-02-3297;8;124;184;316;580
00-2-12-02-3298;5;145;168;318;580
00-2-12-03-3299;0;27;77;104;176
00-2-12-04-3300;13;147;188;348;532
00-2-12-04-3301;12;126;184;322;532
00-2-12-04-3302;7;145;180;332;533
00-2-12-04-3303;9;120;125;254;398
00-2-12-04-3304;7;98;158;263;398
00-2-12-05-3305;5;145;223;373;578
00-2-12-05-3306;9;171;223;403;578
00-2-12-05-3307;4;113;168;285;439
00-2-13-01-3308;5;114;152;271;569
00-2-13-01-3309;3;118;150;271;569
00-2-13-01-3310;7;96;164;267;569
00-2-13-01-3311;8;118;135;261;569
00-2-13-01-3312;3;107;149;259;569
00-2-13-01-3313;5;111;144;260;569
00-2-13-01-3314;2;88;178;268;569
00-2-13-01-3315;12;121;146;279;569
00-2-13-01-3316;7;102;169;278;569
00-2-13-01-3317;6;101;175;282;570
00-2-13-01-3318;3;115;120;238;485
00-2-13-01-3319;3;115;117;235;485
00-2-13-01-3320;7;101;117;225;485
00-2-13-01-3321;9;101;117;227;488
00-2-13-01-3322;5;123;111;239;393
00-2-13-01-3323;2;77;80;159;298
00-2-13-01-3324;8;92;130;230;460
00-2-13-01-3325;1;84;77;162;314
00-2-13-02-3326;4;73;147;224;460
00-2-13-02-3327;2;101;160;263;460
00-2-13-02-3328;3;38;52;93;182
00-2-13-02-3329;3;117;98;218;455
00-2-13-02-3330;4;29;78;111;209
00-2-13-02-3331;11;60;129;200;408
00-2-13-02-3332;3;68;131;202;409
00-2-13-02-3333;1;41;34;76;168
00-2-13-02-3334;8;80;123;211;420
00-2-13-02-3335;4;71;91;166;326
00-2-13-02-3336;9;53;99;161;317
00-2-13-03-3337;5;69;96;170;606
00-2-13-03-3338;7;72;128;207;606
00-2-13-03-3339;7;64;129;200;606
00-2-13-03-3340;4;73;84;161;606
00-2-13-03-3341;5;65;113;183;607
00-2-13-03-3342;1;52;108;161;434
00-2-13-03-3343;3;43;73;119;435
00-2-13-03-3344;0;13;49;62;143
00-2-13-03-3345;5;38;73;116;280
00-2-13-03-3346;9;38;89;136;356
00-2-13-03-3347;2;40;94;136;476
00-2-13-04-3348;5;128;151;284;498
00-2-13-04-3349;2;100;168;270;498
00-2-13-04-3350;5;103;176;284;498
00-2-13-04-3351;5;103;177;285;498
00-2-13-04-3352;6;89;196;291;499
00-2-13-04-3353;3;43;68;114;219
00-2-13-04-3354;0;40;60;100;195
00-2-13-04-3355;7;42;64;113;195
00-2-13-04-3356;9;102;152;263;444
00-2-13-05-3357;5;84;78;167;412
00-2-13-05-3358;6;84;70;160;413
00-2-13-05-3359;6;79;143;228;557
00-2-13-05-3360;3;36;39;78;337
00-2-13-05-3361;1;41;42;84;338
00-2-13-05-3362;8;136;173;317;585
00-2-13-06-3363;2;67;78;147;392
00-2-13-06-3364;2;77;66;145;393
00-2-13-06-3365;2;83;91;176;503
00-2-13-06-3366;3;41;74;118;268
00-2-13-06-3367;5;47;90;142;462
00-2-13-07-3368;5;53;118;176;427
00-2-13-07-3369;2;59;118;179;427
00-2-13-07-3370;2;84;78;164;408
00-2-13-07-3371;5;71;90;166;408
00-2-13-07-3372;3;52;106;161;329
00-2-13-07-3373;6;170;97;273;523
00-2-13-08-3374;5;105;179;289;559
00-2-13-08-3375;5;99;139;243;559
00-2-13-08-3376;2;96;152;250;559
00-2-13-08-3377;13;102;169;284;562
00-2-13-08-3378;0;10;9;19;48
00-2-13-08-3379;5;60;103;168;425
00-2-13-08-3380;8;47;117;172;271
00-2-14-01-3381;4;135;149;288;630
00-2-14-01-3382;4;151;174;329;630
00-2-14-01-3383;6;165;125;296;630
00-2-14-01-3384;3;139;135;277;630
00-2-14-01-3385;7;163;127;297;630
00-2-14-01-3386;5;155;150;310;633
00-2-14-01-3387;1;15;26;42;92
00-2-14-01-3388;7;53;115;175;462
00-2-14-01-3389;1;30;95;126;284
00-2-14-01-3390;2;16;30;48;171
00-2-14-01-3391;3;38;90;131;381
00-2-14-01-3392;1;28;109;138;381
00-2-14-01-3393;7;81;117;205;478
00-2-14-01-3394;4;84;109;197;478
00-2-14-01-3395;4;67;132;203;479
00-2-14-01-3396;5;41;112;158;407
00-2-14-01-3397;1;53;93;147;344
00-2-14-02-3398;4;91;79;174;361
00-2-14-02-3399;4;73;83;160;362
00-2-14-02-3400;9;98;112;219;422
00-2-14-03-3401;8;74;96;178;376
00-2-14-03-3402;0;75;108;183;376
00-2-14-03-3403;2;11;122;135;203
00-2-14-03-3404;3;50;71;124;209
00-2-14-03-3405;3;76;192;271;477
00-2-14-03-3406;4;86;143;233;477
00-2-14-03-3407;3;82;150;235;477
00-2-14-03-3408;3;80;159;242;479
00-2-14-03-3409;0;7;26;33;120
00-2-14-03-3410;4;32;60;96;226
00-2-14-04-3411;2;99;98;199;319
00-2-14-04-3412;1;41;123;165;325
00-2-14-04-3413;2;51;133;186;325
00-2-14-04-3414;0;87;130;217;430
00-2-14-04-3415;2;25;59;86;165
00-2-15-01-3416;2;141;171;314;600
00-2-15-01-3417;4;160;155;319;600
00-2-15-01-3418;6;132;153;291;600
00-2-15-01-3419;13;128;191;332;600
00-2-15-01-3420;11;144;161;316;594
00-2-15-01-3421;6;131;165;302;593
00-2-15-01-3422;3;31;33;67;153
00-2-15-01-3423;5;106;151;262;461
00-2-15-01-3424;4;82;95;181;352
00-2-15-01-3425;5;80;98;183;404
00-2-15-01-3427;5;86;101;192;412
00-2-15-01-3428;0;27;11;38;50
00-2-15-01-3429;3;156;103;262;413
00-2-15-02-3430;7;166;97;270;555
00-2-15-02-3431;2;91;96;189;371
00-2-15-02-3432;1;57;24;82;164
00-2-15-03-3433;2;154;182;338;540
00-2-15-04-3434;6;136;155;297;585
00-2-15-04-3435;5;124;155;284;585
00-2-15-04-3436;7;131;164;302;585
00-2-15-04-3437;9;159;151;319;586
00-2-15-04-3438;3;71;97;171;371
00-2-15-04-3439;4;93;93;190;371
00-2-15-04-3440;8;153;128;289;524
00-2-15-04-3441;2;167;124;293;525
00-2-16-01-3442;1;79;84;164;243
00-2-16-01-3443;9;188;183;380;537
00-2-16-01-3444;4;169;168;341;537
00-2-16-01-3445;4;130;189;323;537
00-2-16-01-3446;9;153;186;348;537
00-2-16-01-3447;1;20;17;38;47
00-2-16-02-3448;6;123;203;332;533
00-2-16-02-3449;3;73;45;121;211
00-2-16-02-3450;4;121;146;271;514
00-2-16-02-3451;2;111;145;258;514
00-2-16-02-3452;3;131;140;274;514
00-2-16-02-3453;1;94;154;249;396
00-2-16-03-3454;2;104;108;214;385
00-2-16-03-3455;0;144;86;230;453
00-2-16-03-3456;2;120;102;224;454
00-2-16-03-3457;0;28;35;63;115
00-2-16-03-3458;2;54;93;149;253
00-3-01-01-3459;16;223;165;404;601
00-3-01-01-3460;13;233;172;418;601
00-3-01-01-3462;19;211;199;429;601
00-3-01-01-3463;13;249;170;432;601
00-3-01-01-3464;12;240;160;412;601
00-3-01-01-3465;15;221;200;436;601
00-3-01-01-3466;8;252;173;433;601
00-3-01-01-3467;11;218;184;413;601
00-3-01-01-3468;7;254;166;427;601
00-3-01-01-3469;15;230;176;421;601
00-3-01-01-3470;14;251;175;440;601
00-3-01-01-3471;19;249;176;444;601
00-3-01-01-3472;17;270;162;449;601
00-3-01-01-3473;15;241;175;431;601
00-3-01-01-3474;15;248;175;438;601
00-3-01-01-3475;12;220;179;411;601
00-3-01-01-3476;15;242;160;417;601
00-3-01-01-3477;14;225;182;421;601
00-3-01-01-3478;10;247;186;443;601
00-3-01-01-3479;17;228;158;403;601
00-3-01-01-3480;10;243;171;424;618
00-3-01-02-3482;12;256;140;408;585
00-3-01-02-3483;10;224;192;426;585
00-3-01-02-3484;12;252;157;421;585
00-3-01-02-3485;15;217;189;421;585
00-3-01-02-3486;12;250;169;431;585
00-3-01-02-3487;13;249;163;425;585
00-3-01-02-3488;16;225;171;412;585
00-3-01-02-3489;20;227;177;424;585
00-3-01-02-3490;13;254;146;413;585
00-3-01-02-3491;16;217;183;416;585
00-3-01-02-3492;15;255;162;432;585
00-3-01-02-3493;18;234;160;412;585
00-3-01-02-3494;9;230;150;389;585
00-3-01-02-3495;10;239;166;415;585
00-3-01-02-3496;12;236;150;398;598
00-3-01-02-3497;0;22;8;30;62
00-3-01-03-3498;8;203;176;387;586
00-3-01-03-3499;8;218;167;393;586
00-3-01-03-3500;19;174;172;365;586
00-3-01-03-3501;21;206;154;381;586
00-3-01-03-3502;7;207;186;400;586
00-3-01-03-3503;16;200;170;386;586
00-3-01-03-3504;17;222;157;396;586
00-3-01-03-3505;8;238;163;409;586
00-3-01-03-3506;11;209;168;388;586
00-3-01-03-3507;12;188;164;364;586
00-3-01-03-3508;18;214;142;374;586
00-3-01-03-3509;11;211;163;385;586
00-3-01-03-3510;11;222;157;390;590
00-3-01-03-3511;11;185;188;384;575
00-3-01-03-3512;12;199;180;391;575
00-3-01-03-3513;16;182;192;390;575
00-3-01-03-3515;15;186;200;401;575
00-3-01-03-3516;14;195;161;370;575
00-3-01-03-3517;16;206;172;394;575
00-3-01-03-3518;12;168;204;384;575
00-3-01-03-3519;10;196;173;379;575
00-3-01-03-3520;16;199;173;388;575
00-3-01-03-3521;18;215;144;377;581
00-3-01-04-3522;8;212;152;372;563
00-3-01-04-3523;7;201;171;379;563
00-3-01-04-3524;14;202;147;363;563
00-3-01-04-3525;5;196;155;356;563
00-3-01-04-3526;12;244;142;398;563
00-3-01-04-3527;8;186;157;351;563
00-3-01-04-3528;11;228;175;414;563
00-3-01-04-3529;13;192;167;372;563
00-3-01-04-3530;8;203;173;384;563
00-3-01-04-3531;13;211;133;357;563
00-3-01-04-3532;11;204;163;378;563
00-3-01-04-3533;13;195;177;385;573
00-3-01-04-3534;8;154;134;296;501
00-3-01-04-3535;11;163;143;317;501
00-3-01-04-3536;8;188;129;325;501
00-3-01-04-3537;6;187;118;311;501
00-3-01-04-3538;7;181;141;329;503
00-3-01-04-3539;10;153;192;355;560
00-3-01-04-3540;14;153;160;327;560
00-3-01-04-3541;10;167;148;325;560
00-3-01-04-3542;13;159;158;330;560
00-3-01-04-3543;14;170;170;354;560
00-3-01-04-3544;21;160;172;353;565
00-3-01-04-3545;20;156;206;382;600
00-3-01-04-3546;12;187;201;400;600
00-3-01-04-3547;8;175;159;342;600
00-3-01-04-3548;15;197;189;401;600
00-3-01-04-3549;14;180;181;375;600
00-3-01-04-3550;15;196;170;381;600
00-3-01-04-3551;9;162;187;358;578
00-3-01-04-3552;14;181;192;387;577
00-3-01-04-3553;11;225;183;419;600
00-3-01-04-3554;13;175;202;390;600
00-3-01-04-3555;17;209;185;411;600
00-3-01-04-3556;12;190;182;384;577
00-3-01-04-3557;12;173;193;378;577
00-3-01-05-3558;12;200;218;430;589
00-3-01-05-3559;13;202;187;402;589
00-3-01-05-3560;7;207;205;419;589
00-3-01-05-3561;15;172;196;383;589
00-3-01-05-3562;13;181;211;405;589
00-3-01-05-3563;11;187;204;402;589
00-3-01-05-3564;15;198;182;395;589
00-3-01-05-3565;16;194;184;394;589
00-3-01-05-3566;15;202;206;423;589
00-3-01-05-3567;13;210;176;399;589
00-3-01-05-3568;12;217;200;429;589
00-3-01-05-3569;14;179;197;390;589
00-3-01-05-3570;7;214;172;393;589
00-3-01-05-3571;15;195;189;399;589
00-3-01-05-3572;10;232;184;426;598
00-3-01-05-3573;21;169;198;388;567
00-3-01-05-3574;15;155;203;373;567
00-3-01-05-3575;12;143;200;355;567
00-3-01-05-3576;17;169;193;379;567
00-3-01-05-3577;11;200;173;384;567
00-3-01-05-3578;14;137;205;356;569
00-3-01-05-3579;10;201;179;390;578
00-3-01-05-3580;12;170;222;404;578
00-3-01-05-3581;9;211;178;398;578
00-3-01-05-3582;8;206;193;407;578
00-3-01-05-3583;14;177;185;376;578
00-3-01-05-3584;18;179;204;401;578
00-3-01-05-3585;9;195;188;392;578
00-3-01-05-3586;18;197;188;403;578
00-3-01-05-3587;20;206;158;384;578
00-3-01-05-3588;10;206;181;397;578
00-3-01-05-3589;8;221;166;395;578
00-3-01-05-3590;8;184;196;388;578
00-3-01-05-3591;20;214;172;406;578
00-3-01-05-3592;14;191;201;406;590
00-3-01-05-3593;17;144;148;309;548
00-3-01-05-3594;11;133;178;322;548
00-3-01-05-3595;8;136;158;302;548
00-3-01-05-3596;4;154;160;318;548
00-3-01-05-3597;20;145;137;302;548
00-3-01-05-3598;15;132;174;321;548
00-3-01-05-3599;12;146;140;298;548
00-3-01-05-3600;15;135;153;303;548
00-3-01-05-3601;6;139;159;304;555
00-3-01-05-3602;8;123;144;275;484
00-3-01-05-3603;6;121;148;275;484
00-3-01-05-3604;7;124;140;271;484
00-3-01-06-3605;13;199;205;417;604
00-3-01-06-3606;6;188;233;427;604
00-3-01-06-3607;5;231;210;446;604
00-3-01-06-3608;19;213;190;422;604
00-3-01-06-3609;17;221;173;411;604
00-3-01-06-3610;12;208;216;436;604
00-3-01-06-3611;13;226;169;408;604
00-3-01-06-3612;8;194;189;391;604
00-3-01-06-3613;11;255;155;421;604
00-3-01-06-3614;9;222;212;443;604
00-3-01-06-3615;15;220;188;423;604
00-3-01-06-3616;16;234;192;442;604
00-3-01-06-3617;14;214;206;434;604
00-3-01-06-3618;11;241;174;426;604
00-3-01-06-3619;16;214;166;396;604
00-3-01-06-3620;12;240;178;430;604
00-3-01-06-3621;14;224;191;429;604
00-3-01-06-3623;8;215;222;445;604
00-3-01-06-3624;14;229;162;405;611
00-3-01-07-3625;14;156;175;345;524
00-3-01-07-3626;11;202;132;345;524
00-3-01-07-3627;8;189;146;343;526
00-3-01-07-3628;4;288;130;422;595
00-3-01-07-3629;3;267;106;376;546
00-3-01-07-3630;12;249;129;390;546
00-3-01-07-3631;14;256;121;391;547
00-3-01-07-3632;16;279;139;434;595
00-3-01-07-3633;11;274;130;415;595
00-3-01-07-3634;8;354;76;438;575
00-3-01-07-3635;6;308;88;402;576
00-3-01-07-3636;10;200;113;323;411
00-3-01-07-3637;9;208;109;326;412
00-3-01-07-3638;9;161;70;240;364
00-3-01-07-3639;7;117;101;225;364
00-3-01-07-3640;5;160;94;259;389
00-3-01-07-3641;12;186;86;284;390
00-3-01-07-3642;4;181;101;286;397
00-3-01-08-3643;9;209;202;420;600
00-3-01-08-3644;10;242;159;411;600
00-3-01-08-3645;7;226;216;449;600
00-3-01-08-3646;14;178;205;397;600
00-3-01-08-3647;13;203;188;404;600
00-3-01-08-3648;13;222;184;419;600
00-3-01-08-3649;18;186;182;386;581
00-3-01-08-3650;16;226;170;412;580
00-3-01-09-3651;9;198;216;423;585
00-3-01-09-3652;10;200;191;401;585
00-3-01-09-3653;13;191;220;424;585
00-3-01-09-3654;5;193;216;414;585
00-3-01-09-3655;15;215;186;416;585
00-3-01-09-3656;13;220;183;416;585
00-3-01-09-3657;9;186;207;402;585
00-3-01-09-3658;15;204;208;427;585
00-3-01-09-3659;14;227;197;438;591
00-3-01-09-3660;1;85;89;175;251
00-3-01-09-3661;7;204;163;374;547
00-3-01-09-3662;8;200;171;379;547
00-3-01-09-3663;7;184;191;382;547
00-3-01-09-3664;21;171;187;379;547
00-3-01-09-3665;16;177;208;401;547
00-3-01-09-3666;16;194;176;386;547
00-3-01-09-3667;11;167;215;393;549
00-3-01-10-3668;14;183;148;345;595
00-3-01-10-3669;6;219;158;383;595
00-3-01-10-3670;14;205;134;353;595
00-3-01-10-3671;8;208;147;363;597
00-3-01-10-3672;11;220;161;392;584
00-3-01-10-3673;9;202;177;388;584
00-3-01-11-3674;12;176;174;362;552
00-3-01-11-3675;7;183;185;375;552
00-3-01-11-3676;11;175;180;366;552
00-3-01-11-3677;10;190;164;364;552
00-3-01-11-3678;7;173;207;387;552
00-3-01-11-3679;11;182;181;374;552
00-3-01-11-3680;16;161;214;391;553
00-3-01-11-3681;5;136;140;281;512
00-3-01-11-3682;5;131;117;253;512
00-3-01-11-3683;7;138;142;287;514
00-3-01-11-3684;5;135;62;202;322
00-3-02-01-3685;6;169;188;363;591
00-3-02-01-3686;15;196;178;389;591
00-3-02-01-3687;9;206;185;400;591
00-3-02-01-3688;9;202;201;412;591
00-3-02-01-3689;12;201;198;411;591
00-3-02-01-3690;11;161;201;373;591
00-3-02-01-3692;12;158;230;400;591
00-3-02-01-3693;9;174;218;401;591
00-3-02-01-3694;11;184;213;408;591
00-3-02-01-3695;17;159;207;383;591
00-3-02-01-3696;14;160;193;367;591
00-3-02-01-3697;5;177;206;388;591
00-3-02-01-3698;11;199;228;438;591
00-3-02-01-3699;7;209;185;401;591
00-3-02-01-3700;14;194;181;389;591
00-3-02-01-3701;16;202;191;409;591
00-3-02-01-3702;8;181;194;383;591
00-3-02-01-3703;8;180;203;391;591
00-3-02-01-3704;6;197;210;413;591
00-3-02-01-3705;12;196;208;416;591
00-3-02-01-3706;3;184;200;387;591
00-3-02-01-3707;10;201;206;417;591
00-3-02-01-3708;14;162;212;388;591
00-3-02-01-3709;16;218;185;419;591
00-3-02-01-3710;9;215;182;406;591
00-3-02-01-3711;8;179;217;404;591
00-3-02-01-3712;9;183;190;382;618
00-3-02-01-3713;12;154;138;304;519
00-3-02-01-3714;9;157;142;308;519
00-3-02-01-3715;12;122;158;292;519
00-3-02-01-3716;10;150;139;299;519
00-3-02-01-3717;12;147;136;295;519
00-3-02-01-3718;5;136;107;248;443
00-3-02-01-3719;10;111;138;259;444
00-3-02-02-3720;13;162;166;341;529
00-3-02-02-3721;8;186;149;343;529
00-3-02-02-3722;5;156;167;328;531
00-3-02-02-3723;6;134;106;246;387
00-3-02-02-3724;8;139;76;223;388
00-3-02-02-3725;15;192;153;360;530
00-3-02-02-3726;5;72;107;184;320
00-3-02-02-3727;3;69;93;165;320
00-3-02-02-3728;4;146;93;243;361
00-3-02-02-3729;4;95;95;194;319
00-3-02-02-3730;4;102;89;195;319
00-3-02-03-3731;4;172;247;423;600
00-3-02-03-3732;8;158;234;400;600
00-3-02-03-3733;9;164;215;388;600
00-3-02-03-3734;16;192;200;408;600
00-3-02-03-3735;9;171;220;400;600
00-3-02-03-3736;12;146;220;378;600
00-3-02-03-3737;11;154;214;379;574
00-3-02-03-3738;10;143;209;362;573
00-3-02-03-3739;4;113;121;238;355
00-3-02-03-3740;9;89;125;223;355
00-3-02-03-3741;10;145;147;302;574
00-3-02-03-3742;12;158;181;351;574
00-3-02-03-3743;9;162;199;370;575
00-3-02-03-3744;2;44;72;118;209
00-3-02-03-3745;5;95;68;168;282
00-3-02-03-3746;2;19;69;90;144
00-3-02-04-3747;12;211;168;391;600
00-3-02-04-3748;17;225;174;416;600
00-3-02-04-3749;11;217;143;371;600
00-3-02-04-3750;13;194;160;367;600
00-3-02-04-3751;15;210;139;364;583
00-3-02-04-3752;14;168;190;372;582
00-3-02-04-3753;13;143;235;391;543
00-3-02-04-3754;7;72;54;133;249
00-3-02-04-3755;12;119;149;280;408
00-3-02-04-3756;1;25;17;43;80
00-3-02-05-3757;14;142;204;360;611
00-3-02-05-3758;7;141;207;355;611
00-3-02-05-3759;20;165;209;394;611
00-3-02-05-3760;11;131;219;361;611
00-3-02-05-3761;5;167;231;403;611
00-3-02-05-3762;18;147;223;388;611
00-3-02-05-3763;18;170;188;376;611
00-3-02-05-3764;21;153;187;361;611
00-3-02-05-3765;12;183;191;386;611
00-3-02-05-3766;8;148;210;366;611
00-3-02-05-3767;7;158;175;340;611
00-3-02-05-3768;7;154;213;374;611
00-3-02-05-3769;14;149;191;354;611
00-3-02-05-3770;7;154;216;377;611
00-3-02-05-3771;15;156;170;341;611
00-3-02-05-3772;21;158;196;375;611
00-3-02-05-3773;10;179;158;347;611
00-3-02-05-3774;14;173;196;383;611
00-3-02-05-3775;9;154;195;358;611
00-3-02-05-3776;10;127;203;340;615
00-3-03-01-3777;10;229;170;409;600
00-3-03-01-3778;11;220;180;411;600
00-3-03-01-3779;14;220;173;407;600
00-3-03-01-3780;10;213;181;404;600
00-3-03-01-3781;13;191;226;430;600
00-3-03-01-3782;9;244;159;412;600
00-3-03-01-3783;10;230;198;438;600
00-3-03-01-3784;6;243;160;409;600
00-3-03-01-3785;15;206;178;399;600
00-3-03-01-3786;13;189;177;379;600
00-3-03-01-3787;12;230;161;403;600
00-3-03-01-3788;11;237;186;434;600
00-3-03-01-3789;7;184;188;379;600
00-3-03-01-3790;11;205;170;386;600
00-3-03-01-3791;8;246;168;422;600
00-3-03-01-3792;8;216;203;427;600
00-3-03-01-3793;13;174;208;395;600
00-3-03-01-3794;12;194;183;389;600
00-3-03-01-3795;8;197;184;389;565
00-3-03-01-3796;9;191;171;371;565
00-3-03-02-3797;8;175;163;346;587
00-3-03-02-3798;8;180;201;389;587
00-3-03-02-3799;14;197;176;387;587
00-3-03-02-3800;12;188;188;388;587
00-3-03-02-3801;7;180;198;385;587
00-3-03-02-3802;9;172;174;355;587
00-3-03-02-3803;8;181;187;376;587
00-3-03-02-3804;7;200;156;363;587
00-3-03-02-3805;7;183;185;375;587
00-3-03-02-3806;9;170;195;374;587
00-3-03-02-3808;9;180;188;377;587
00-3-03-02-3809;11;205;185;401;587
00-3-03-02-3810;12;124;164;300;568
00-3-03-02-3812;9;150;169;328;568
00-3-03-02-3813;3;130;149;282;568
00-3-03-02-3814;7;111;154;272;568
00-3-03-02-3815;6;132;137;275;568
00-3-03-02-3816;6;168;131;305;568
00-3-03-02-3817;7;131;143;281;568
00-3-03-02-3818;9;136;173;318;568
00-3-03-02-3819;5;136;140;281;568
00-3-03-02-3820;8;129;172;309;571
00-3-03-02-3821;9;114;109;232;444
00-3-03-02-3822;4;110;102;216;444
00-3-03-02-3823;6;115;112;233;445
00-3-03-03-3825;16;242;136;394;538
00-3-03-03-3826;8;247;140;395;538
00-3-03-03-3827;9;255;119;383;538
00-3-03-03-3828;8;281;120;409;538
00-3-03-03-3829;14;253;120;387;538
00-3-03-03-3830;12;256;123;391;539
00-3-03-03-3831;4;211;167;382;544
00-3-03-03-3832;14;215;151;380;544
00-3-03-03-3833;11;184;164;359;544
00-3-03-03-3834;12;203;147;362;544
00-3-03-03-3835;8;213;154;375;544
00-3-03-03-3836;12;201;158;371;544
00-3-03-03-3837;7;185;188;380;544
00-3-03-03-3838;15;218;164;397;547
00-3-03-04-3839;9;220;161;390;587
00-3-03-04-3840;9;205;176;390;587
00-3-03-04-3841;12;221;167;400;587
00-3-03-04-3842;12;203;165;380;587
00-3-03-04-3844;10;221;159;390;587
00-3-03-04-3845;16;213;162;391;587
00-3-03-04-3846;13;216;177;406;587
00-3-03-04-3847;12;220;196;428;595
00-3-03-04-3848;9;239;118;366;596
00-3-03-04-3849;7;199;133;339;597
00-3-03-04-3850;7;117;165;289;594
00-3-03-04-3851;5;150;147;302;594
00-3-03-04-3852;7;141;176;324;594
00-3-03-04-3853;12;125;153;290;594
00-3-03-04-3854;15;165;154;334;519
00-3-03-04-3855;10;173;169;352;519
00-3-03-05-3856;11;227;171;409;607
00-3-03-05-3857;8;200;187;395;607
00-3-03-05-3858;16;181;208;405;607
00-3-03-05-3859;8;221;190;419;607
00-3-03-05-3860;7;221;182;410;607
00-3-03-05-3861;15;201;175;391;607
00-3-03-05-3862;19;174;178;371;607
00-3-03-05-3863;11;190;174;375;607
00-3-03-05-3864;11;225;177;413;607
00-3-03-05-3865;7;204;179;390;607
00-3-03-05-3866;9;200;174;383;607
00-3-03-05-3867;15;195;187;397;607
00-3-03-05-3868;8;224;160;392;607
00-3-03-05-3869;8;213;182;403;607
00-3-03-05-3870;8;192;182;382;607
00-3-03-05-3871;8;207;167;382;607
00-3-03-05-3872;16;185;180;381;616
00-3-03-05-3873;9;113;130;252;395
00-3-03-05-3874;7;134;127;268;396
00-3-03-05-3875;4;103;138;245;506
00-3-03-05-3876;9;115;147;271;506
00-3-03-05-3877;7;110;139;256;506
00-3-03-05-3878;8;120;151;279;508
00-3-03-05-3879;11;188;164;363;563
00-3-03-06-3880;10;133;157;300;539
00-3-03-06-3881;5;147;167;319;539
00-3-03-06-3882;5;162;150;317;539
00-3-03-06-3883;9;149;172;330;539
00-3-03-06-3884;7;168;154;329;539
00-3-03-06-3885;7;147;193;347;544
00-3-03-06-3886;6;134;179;319;565
00-3-03-06-3887;6;141;157;304;565
00-3-03-06-3888;7;137;171;315;565
00-3-03-06-3889;8;160;163;331;565
00-3-03-06-3890;9;164;134;307;565
00-3-03-07-3891;11;199;163;373;600
00-3-03-07-3892;10;216;162;388;600
00-3-03-07-3893;15;205;138;358;600
00-3-03-07-3894;15;202;150;367;600
00-3-03-07-3895;9;198;148;355;584
00-3-03-07-3896;11;178;179;368;583
00-3-03-08-3897;10;117;140;267;600
00-3-03-08-3898;6;173;132;311;600
00-3-03-08-3899;11;141;144;296;600
00-3-03-08-3900;6;127;116;249;562
00-3-03-08-3901;3;152;121;276;561
00-3-03-08-3902;2;118;135;255;515
00-3-03-08-3903;4;122;136;262;515
00-3-03-08-3904;4;98;123;225;515
00-3-03-08-3905;4;94;131;229;515
00-3-03-08-3906;3;97;125;225;515
00-3-03-08-3907;5;120;115;240;516
00-3-04-01-3908;10;179;195;384;600
00-3-04-01-3909;10;217;151;378;600
00-3-04-01-3910;11;200;156;367;600
00-3-04-01-3911;14;187;159;360;558
00-3-04-01-3912;9;181;177;367;558
00-3-04-01-3913;19;120;141;280;469
00-3-04-01-3914;3;114;164;281;469
00-3-04-01-3915;9;119;148;276;471
00-3-04-01-3916;2;7;25;34;54
00-3-04-01-3917;6;152;176;334;584
00-3-04-01-3918;4;91;76;171;326
00-3-04-01-3919;9;160;148;317;471
00-3-04-02-3920;4;110;174;288;494
00-3-04-02-3921;7;116;142;265;494
00-3-04-02-3922;10;123;148;281;494
00-3-04-02-3923;6;136;167;309;494
00-3-04-02-3924;6;112;180;298;494
00-3-04-02-3925;10;93;124;227;381
00-3-04-02-3926;8;92;100;200;382
00-3-04-02-3927;7;80;111;198;372
00-3-04-02-3928;9;86;108;203;372
00-3-04-03-3929;6;166;131;303;537
00-3-04-03-3930;5;157;153;315;537
00-3-04-03-3931;4;132;151;287;537
00-3-04-03-3932;8;155;181;344;540
00-3-04-03-3933;1;60;33;94;208
00-3-04-03-3934;3;146;106;255;342
00-3-04-03-3935;8;127;115;250;343
00-3-05-01-3936;12;167;162;341;552
00-3-05-01-3937;15;175;170;360;552
00-3-05-01-3938;12;177;172;361;552
00-3-05-01-3939;11;175;176;362;552
00-3-05-01-3940;11;188;174;373;552
00-3-05-01-3941;16;162;195;373;552
00-3-05-01-3942;14;176;169;359;552
00-3-05-01-3943;11;192;146;349;552
00-3-05-01-3944;14;189;159;362;555
00-3-05-01-3945;10;174;157;341;550
00-3-05-01-3946;14;157;187;358;550
00-3-05-01-3947;12;161;184;357;550
00-3-05-01-3948;7;191;132;330;507
00-3-05-01-3949;8;131;145;284;507
00-3-05-01-3950;11;123;153;287;463
00-3-05-01-3951;9;143;157;309;463
00-3-05-01-3952;17;205;172;394;603
00-3-05-01-3953;12;178;182;372;603
00-3-05-01-3954;14;181;193;388;603
00-3-05-01-3955;14;205;181;400;603
00-3-05-01-3956;12;189;184;385;603
00-3-05-01-3957;16;192;193;401;603
00-3-05-01-3958;10;229;153;392;603
00-3-05-01-3959;9;200;165;374;609
00-3-05-01-3960;2;55;54;111;234
00-3-05-01-3961;12;115;107;234;408
00-3-05-01-3962;6;131;123;260;409
00-3-05-01-3963;0;31;38;69;156
00-3-05-01-3964;12;143;160;315;456
00-3-05-01-3965;6;155;137;298;456
00-3-05-01-3966;3;78;135;216;387
00-3-05-01-3967;5;66;127;198;387
00-3-05-01-3968;15;184;159;358;555
00-3-05-01-3969;8;144;171;323;555
00-3-05-01-3970;6;161;174;341;555
00-3-05-01-3971;8;144;179;331;555
00-3-05-01-3972;19;164;171;354;555
00-3-05-01-3973;11;163;166;340;559
00-3-05-01-3975;13;183;145;341;511
00-3-05-01-3976;11;170;151;332;511
00-3-05-01-3977;8;142;170;320;511
00-3-05-01-3978;11;163;156;330;511
00-3-05-01-3979;9;154;172;335;511
00-3-05-01-3980;12;173;150;335;514
00-3-05-02-3981;12;175;95;282;439
00-3-05-02-3982;7;155;158;320;603
00-3-05-02-3983;11;129;186;326;603
00-3-05-02-3984;15;136;170;321;603
00-3-05-02-3985;11;135;176;322;603
00-3-05-02-3986;4;158;152;314;603
00-3-05-02-3987;14;157;151;322;607
00-3-05-02-3988;1;38;40;79;174
00-3-05-02-3989;2;58;60;120;168
00-3-05-02-3990;4;63;83;150;260
00-3-05-02-3991;0;63;65;128;180
00-3-05-02-3992;1;78;59;138;272
00-3-05-02-3993;11;164;122;297;485
00-3-05-02-3994;12;144;135;291;485
00-3-05-02-3995;6;123;164;293;485
00-3-05-02-3996;13;164;144;321;486
00-3-05-02-3997;1;12;18;31;54
00-3-05-03-3998;4;130;55;189;335
00-3-05-04-3999;3;116;111;230;377
00-3-05-04-4000;12;123;107;242;378
00-3-05-04-4001;10;154;121;285;432
00-3-05-04-4002;8;135;75;218;380
00-3-05-04-4003;3;129;98;230;381
00-3-05-04-4004;3;88;63;154;267
00-3-05-04-4005;10;128;130;268;407
00-3-05-04-4006;7;144;102;253;386
00-3-05-04-4007;2;58;27;87;144
00-3-05-05-4008;0;15;14;29;67
00-3-05-05-4009;2;40;43;85;160
00-3-05-05-4010;7;114;86;207;419
00-3-05-05-4011;6;145;83;234;419
00-3-05-05-4012;4;116;87;207;421
00-3-05-05-4013;16;140;206;362;523
00-3-05-05-4014;9;106;107;222;399
00-3-05-05-4015;3;168;61;232;352
00-3-05-05-4016;5;105;89;199;319
00-3-05-05-4017;6;55;38;99;182
00-3-05-05-4018;5;136;68;209;317
00-3-05-05-4019;3;166;44;213;317
00-3-05-05-4020;6;73;98;177;334
00-3-05-06-4021;7;130;136;273;566
00-3-05-06-4022;13;150;148;311;566
00-3-05-06-4023;20;149;121;290;492
00-3-05-06-4024;5;76;105;186;334
00-3-05-06-4025;16;97;84;197;334
00-3-05-06-4026;14;136;170;320;556
00-3-05-06-4027;12;125;107;244;483
00-3-05-06-4028;4;115;119;238;484
00-3-05-07-4029;12;107;123;242;451
00-3-05-07-4030;8;114;123;245;451
00-3-05-07-4031;17;124;116;257;451
00-3-05-07-4032;9;91;47;147;235
00-3-05-07-4033;6;86;75;167;288
00-3-05-07-4034;1;23;17;41;88
00-3-05-08-4035;7;129;128;264;467
00-3-05-08-4036;7;143;142;292;467
00-3-05-08-4037;8;149;122;279;468
00-3-05-08-4038;2;28;56;86;171
00-3-05-08-4039;8;78;80;166;341
00-3-05-09-4040;13;196;165;374;603
00-3-05-09-4041;9;187;152;348;604
00-3-05-09-4042;9;179;163;351;559
00-3-05-09-4043;9;191;160;360;559
00-3-05-09-4045;5;198;141;344;559
00-3-05-09-4046;12;163;166;341;537
00-3-05-10-4047;0;64;51;115;277
00-3-05-10-4048;5;85;107;197;413
00-3-05-10-4049;11;102;111;224;413
00-3-05-10-4050;9;104;108;221;415
00-3-05-11-4051;12;118;115;245;486
00-3-05-11-4052;10;101;142;253;486
00-3-05-11-4053;6;104;153;263;486
00-3-05-11-4054;8;125;131;264;487
00-3-05-11-4055;9;85;169;263;432
00-3-05-11-4056;3;80;87;170;233
00-3-05-11-4057;11;125;172;308;577
00-3-05-11-4058;10;129;160;299;577
00-3-05-11-4059;15;123;202;340;577
00-3-05-11-4060;19;134;165;318;580
00-3-05-12-4061;14;62;125;201;478
00-3-05-12-4062;9;68;145;222;479
00-3-05-12-4063;1;26;129;156;333
00-3-05-12-4064;3;11;28;42;271
00-3-05-12-4065;5;30;65;100;419
00-3-05-12-4066;3;29;127;159;368
00-3-05-12-4067;2;9;69;80;226
00-3-05-12-4068;0;6;43;49;119
00-3-05-12-4069;16;20;123;159;562
00-3-05-12-4070;4;22;129;155;392
00-3-05-12-4071;2;10;14;26;78
00-3-05-12-4072;0;7;14;21;128
00-3-05-12-4073;0;7;14;21;39
00-3-06-01-4074;17;201;169;387;600
00-3-06-01-4075;5;196;171;372;600
00-3-06-01-4076;11;215;182;408;600
00-3-06-01-4077;15;185;183;383;600
00-3-06-01-4078;10;167;172;349;558
00-3-06-01-4079;7;171;169;347;557
00-3-06-01-4081;1;45;51;97;169
00-3-06-01-4082;9;134;78;221;357
00-3-06-01-4083;3;59;66;128;289
00-3-06-02-4084;11;192;165;368;553
00-3-06-02-4085;9;191;157;357;553
00-3-06-02-4086;12;184;173;369;553
00-3-06-02-4087;4;156;173;333;553
00-3-06-02-4088;11;173;188;372;553
00-3-06-02-4089;12;170;151;333;553
00-3-06-02-4090;7;155;162;324;553
00-3-06-02-4091;8;162;181;351;553
00-3-06-02-4092;10;191;150;351;561
00-3-06-03-4093;15;158;246;419;594
00-3-06-03-4094;13;172;249;434;595
00-3-06-03-4096;1;14;27;42;71
00-3-07-01-4097;17;171;204;392;587
00-3-07-01-4098;9;218;154;381;587
00-3-07-01-4099;5;207;203;415;587
00-3-07-01-4100;12;173;189;374;587
00-3-07-01-4101;18;215;179;412;587
00-3-07-01-4102;19;174;171;364;587
00-3-07-01-4103;16;243;162;421;587
00-3-07-01-4104;7;237;157;401;587
00-3-07-01-4105;10;211;190;411;587
00-3-07-01-4106;14;212;173;399;587
00-3-07-01-4107;11;171;174;356;587
00-3-07-01-4108;13;180;188;381;587
00-3-07-01-4109;9;235;169;413;587
00-3-07-01-4110;6;205;197;408;587
00-3-07-01-4111;17;168;201;386;587
00-3-07-01-4112;11;205;172;388;587
00-3-07-01-4113;12;211;186;409;587
00-3-07-01-4114;8;184;165;357;587
00-3-07-01-4115;12;188;206;406;587
00-3-07-01-4116;9;194;176;379;587
00-3-07-01-4117;22;224;158;404;587
00-3-07-01-4118;17;188;184;389;603
00-3-07-01-4119;7;152;203;362;600
00-3-07-01-4120;13;135;201;349;600
00-3-07-01-4121;11;162;174;347;600
00-3-07-01-4122;11;170;189;370;600
00-3-07-01-4123;10;158;184;352;600
00-3-07-01-4124;10;138;211;359;577
00-3-07-01-4125;11;151;173;335;576
00-3-07-01-4126;13;194;178;385;559
00-3-07-01-4127;14;213;156;383;559
00-3-07-01-4128;5;203;168;376;559
00-3-07-01-4129;5;208;177;390;559
00-3-07-01-4130;13;181;176;370;559
00-3-07-01-4131;13;205;173;391;559
00-3-07-01-4133;17;187;183;387;559
00-3-07-01-4134;13;195;186;394;559
00-3-07-01-4135;9;199;171;379;559
00-3-07-01-4136;11;192;172;375;560
00-3-07-02-4137;27;171;192;390;607
00-3-07-02-4138;20;174;212;406;607
00-3-07-02-4139;26;140;225;391;607
00-3-07-02-4140;14;182;190;386;607
00-3-07-02-4141;13;173;225;411;607
00-3-07-02-4142;21;159;230;410;607
00-3-07-02-4143;22;157;206;385;607
00-3-07-02-4144;12;164;206;382;607
00-3-07-02-4145;22;199;190;411;607
00-3-07-02-4146;15;185;203;403;607
00-3-07-02-4147;13;160;208;381;612
00-3-07-02-4148;10;167;145;322;581
00-3-07-02-4149;11;161;155;327;582
00-3-07-03-4150;12;177;177;366;505
00-3-07-03-4151;17;165;157;339;505
00-3-07-03-4152;4;164;176;344;569
00-3-07-04-4153;17;221;124;362;605
00-3-07-04-4154;12;238;126;376;605
00-3-07-04-4155;11;235;131;377;605
00-3-07-04-4156;13;222;133;368;605
00-3-07-04-4157;10;244;138;392;609
00-3-07-05-4158;6;155;84;245;443
00-3-07-05-4159;10;152;118;280;443
00-3-07-05-4160;10;147;125;282;445
00-3-07-05-4161;10;180;112;302;613
00-3-07-05-4162;0;6;1;7;88
00-3-07-05-4163;7;219;97;323;444
00-3-08-01-4164;15;204;189;408;587
00-3-08-01-4165;16;198;196;410;587
00-3-08-01-4166;18;241;187;446;587
00-3-08-01-4167;12;217;176;405;587
00-3-08-01-4168;13;219;191;423;587
00-3-08-01-4169;12;175;185;372;587
00-3-08-01-4170;14;202;167;383;587
00-3-08-01-4171;8;199;186;393;587
00-3-08-01-4172;4;221;179;404;587
00-3-08-01-4173;12;235;168;415;587
00-3-08-01-4174;9;180;212;401;587
00-3-08-01-4175;12;204;205;421;587
00-3-08-01-4176;15;221;179;415;587
00-3-08-01-4177;12;178;212;402;587
00-3-08-01-4178;7;179;195;381;587
00-3-08-01-4179;8;195;177;380;587
00-3-08-01-4181;13;225;164;402;587
00-3-08-01-4182;9;202;159;370;603
00-3-08-01-4183;10;210;215;435;600
00-3-08-01-4184;10;205;213;428;600
00-3-08-01-4185;18;220;167;405;600
00-3-08-01-4186;15;224;189;428;600
00-3-08-01-4187;13;246;199;458;600
00-3-08-01-4188;20;224;183;427;600
00-3-08-01-4189;19;206;203;428;600
00-3-08-01-4190;8;237;163;408;600
00-3-08-01-4191;6;236;187;429;600
00-3-08-01-4192;14;221;191;426;600
00-3-08-01-4193;14;249;153;416;603
00-3-08-01-4194;14;185;185;384;526
00-3-08-01-4195;12;196;162;370;526
00-3-08-01-4196;14;192;168;374;526
00-3-08-01-4197;9;186;174;369;527
00-3-08-01-4198;6;169;112;287;388
00-3-08-01-4199;1;100;85;186;466
00-3-08-02-4200;11;212;146;369;559
00-3-08-02-4201;12;196;166;374;559
00-3-08-02-4202;13;209;137;359;559
00-3-08-02-4203;11;235;126;372;559
00-3-08-02-4204;16;201;140;357;559
00-3-08-02-4205;9;219;142;370;559
00-3-08-02-4206;11;208;144;363;559
00-3-08-02-4207;7;226;144;377;559
00-3-08-02-4208;12;209;134;355;559
00-3-08-02-4209;15;224;143;382;563
00-3-08-02-4210;4;158;73;235;321
00-3-08-02-4211;7;153;59;219;321
00-3-08-02-4212;6;224;111;341;483
00-3-08-02-4213;11;166;145;322;466
00-3-08-02-4214;13;165;120;298;467
00-3-08-02-4215;6;174;81;261;381
00-3-08-02-4216;12;186;147;345;543
00-3-08-03-4217;9;198;184;391;600
00-3-08-03-4218;5;186;196;387;600
00-3-08-03-4219;19;182;186;387;600
00-3-08-03-4220;12;162;219;393;600
00-3-08-03-4221;10;180;229;419;600
00-3-08-03-4222;15;170;189;374;592
00-3-08-03-4223;10;181;186;377;592
00-3-08-03-4224;7;197;215;419;593
00-3-08-03-4225;11;172;237;420;593
00-3-08-03-4226;9;152;104;265;358
00-3-08-03-4227;10;135;112;257;358
00-3-08-04-4228;2;60;20;82;131
00-3-08-04-4229;0;185;52;237;296
00-4-01-01-4230;11;176;194;381;596
00-4-01-01-4231;4;188;196;388;596
00-4-01-01-4232;10;179;190;379;596
00-4-01-01-4233;11;204;157;372;596
00-4-01-01-4234;9;178;164;351;596
00-4-01-01-4235;7;208;216;431;596
00-4-01-01-4236;9;167;179;355;596
00-4-01-01-4237;6;195;166;367;596
00-4-01-01-4238;11;163;177;351;596
00-4-01-01-4239;17;198;158;373;596
00-4-01-01-4240;11;180;187;378;596
00-4-01-01-4241;23;171;177;371;596
00-4-01-01-4242;16;179;200;395;596
00-4-01-01-4243;12;190;178;380;596
00-4-01-01-4244;6;173;171;350;596
00-4-01-01-4245;10;176;175;361;596
00-4-01-01-4247;11;202;161;374;596
00-4-01-01-4248;14;180;176;370;596
00-4-01-01-4249;15;173;154;342;596
00-4-01-01-4250;9;186;161;356;596
00-4-01-01-4251;12;174;187;373;596
00-4-01-01-4252;6;192;164;362;596
00-4-01-01-4253;6;192;167;365;596
00-4-01-01-4254;11;158;178;347;596
00-4-01-01-4255;12;204;156;372;596
00-4-01-01-4256;9;194;197;400;596
00-4-01-01-4257;10;189;195;394;596
00-4-01-01-4258;8;233;177;418;609
00-4-01-02-4259;15;207;193;415;608
00-4-01-02-4260;11;197;178;386;608
00-4-01-02-4261;15;211;175;401;608
00-4-01-02-4262;14;203;183;400;608
00-4-01-02-4263;16;220;161;397;608
00-4-01-02-4264;7;212;168;387;608
00-4-01-02-4265;7;212;171;390;608
00-4-01-02-4266;10;206;179;395;608
00-4-01-02-4267;18;201;155;374;608
00-4-01-02-4268;7;172;180;359;608
00-4-01-02-4269;17;180;198;395;608
00-4-01-02-4270;12;208;203;423;608
00-4-01-02-4271;11;209;192;412;608
00-4-01-02-4272;10;173;217;400;608
00-4-01-02-4273;15;233;179;427;608
00-4-01-02-4274;7;195;194;396;608
00-4-01-02-4275;14;200;180;394;608
00-4-01-02-4276;10;179;222;411;608
00-4-01-02-4277;15;213;205;433;608
00-4-01-02-4278;16;227;174;417;608
00-4-01-02-4279;10;199;198;407;609
00-4-01-02-4280;10;201;197;408;609
00-4-01-02-4281;14;209;193;416;609
00-4-01-02-4282;12;179;209;400;609
00-4-01-02-4283;17;207;182;406;609
00-4-01-02-4284;10;217;193;420;609
00-4-01-02-4285;10;185;225;420;609
00-4-01-02-4287;14;208;205;427;609
00-4-01-02-4288;12;197;196;405;609
00-4-01-02-4289;9;190;198;397;609
00-4-01-02-4290;9;213;197;419;609
00-4-01-02-4291;10;206;199;415;609
00-4-01-02-4292;17;197;198;412;609
00-4-01-02-4293;15;226;188;429;609
00-4-01-02-4294;11;166;246;423;609
00-4-01-02-4295;10;196;209;415;609
00-4-01-02-4296;14;219;181;414;609
00-4-01-03-4297;10;220;159;389;600
00-4-01-03-4298;6;207;179;392;600
00-4-01-03-4299;12;199;181;392;600
00-4-01-03-4300;14;196;176;386;600
00-4-01-03-4301;11;194;165;370;600
00-4-01-03-4302;7;180;185;372;600
00-4-01-03-4303;8;183;170;361;600
00-4-01-03-4304;12;203;180;395;600
00-4-01-03-4305;8;210;165;383;600
00-4-01-03-4306;10;210;172;392;600
00-4-01-03-4307;6;201;169;376;600
00-4-01-03-4308;9;184;190;383;600
00-4-01-03-4309;2;204;170;376;600
00-4-01-03-4310;14;155;174;343;600
00-4-01-03-4311;16;204;161;381;600
00-4-01-03-4312;5;207;166;378;600
00-4-01-03-4313;8;186;183;377;600
00-4-01-03-4314;14;196;155;365;600
00-4-01-03-4315;10;179;189;378;600
00-4-01-03-4316;7;194;192;393;600
00-4-01-03-4317;6;206;159;371;600
00-4-01-03-4318;10;174;192;376;600
00-4-01-03-4319;8;172;173;353;600
00-4-01-03-4320;7;181;162;350;600
00-4-01-03-4321;9;204;161;374;600
00-4-01-03-4322;12;190;198;400;618
00-4-01-03-4323;13;165;172;350;558
00-4-01-03-4324;8;147;194;349;558
00-4-01-03-4325;9;172;187;368;558
00-4-01-03-4326;8;155;191;354;558
00-4-01-03-4327;12;159;173;344;558
00-4-01-03-4328;10;157;191;358;558
00-4-01-03-4329;21;170;167;358;558
00-4-01-03-4330;13;173;173;359;574
00-4-01-03-4331;10;162;141;313;574
00-4-01-03-4332;2;155;186;343;574
00-4-01-03-4333;6;134;192;332;574
00-4-01-03-4334;7;155;168;330;574
00-4-01-03-4335;20;169;163;352;574
00-4-01-03-4336;11;147;175;333;574
00-4-01-03-4337;8;171;170;349;575
00-4-01-03-4338;9;107;158;274;601
00-4-01-03-4339;9;109;148;266;601
00-4-01-03-4340;5;97;165;267;601
00-4-01-03-4341;10;91;185;286;601
00-4-01-03-4342;8;99;148;255;601
00-4-01-03-4343;6;96;165;267;601
00-4-01-03-4344;10;92;157;259;601
00-4-01-03-4345;7;105;164;276;601
00-4-01-03-4346;4;103;142;249;601
00-4-01-03-4347;5;120;149;274;601
00-4-01-03-4348;8;92;177;277;601
00-4-01-03-4349;10;103;172;285;601
00-4-01-03-4350;6;87;170;263;601
00-4-01-03-4351;9;93;174;276;601
00-4-01-03-4352;4;104;158;266;601
00-4-01-03-4353;9;109;170;288;601
00-4-01-03-4354;7;124;156;287;601
00-4-01-03-4355;12;112;153;277;601
00-4-01-03-4357;8;122;167;297;613
00-4-01-03-4358;3;123;189;315;475
00-4-01-03-4359;9;120;151;280;475
00-4-01-03-4360;3;117;148;268;475
00-4-01-03-4361;9;121;161;291;478
00-4-01-04-4362;4;203;165;372;574
00-4-01-04-4363;5;179;186;370;574
00-4-01-04-4364;7;178;176;361;574
00-4-01-04-4365;4;182;162;348;574
00-4-01-04-4366;17;159;172;348;574
00-4-01-04-4367;8;142;190;340;574
00-4-01-04-4368;13;172;176;361;574
00-4-01-04-4369;10;147;179;336;574
00-4-01-04-4370;8;157;187;352;574
00-4-01-04-4371;15;154;201;370;574
00-4-01-04-4372;7;166;167;340;574
00-4-01-04-4373;14;180;163;357;574
00-4-01-04-4374;8;189;190;387;582
00-4-01-04-4375;9;176;194;379;601
00-4-01-04-4376;11;174;186;371;601
00-4-01-04-4377;12;147;212;371;601
00-4-01-04-4378;6;157;194;357;601
00-4-01-04-4379;6;166;186;358;601
00-4-01-04-4380;5;174;204;383;601
00-4-01-04-4381;5;169;212;386;601
00-4-01-04-4382;7;167;183;357;601
00-4-01-04-4383;3;158;186;347;601
00-4-01-04-4384;10;165;171;346;601
00-4-01-04-4385;11;144;203;358;601
00-4-01-04-4386;11;176;186;373;601
00-4-01-04-4387;12;171;194;377;601
00-4-01-04-4388;16;163;179;358;601
00-4-01-04-4389;9;177;182;368;601
00-4-01-04-4390;8;175;184;367;613
00-4-01-04-4391;9;156;178;343;559
00-4-01-04-4392;7;176;176;359;559
00-4-01-04-4393;8;176;163;347;559
00-4-01-04-4394;6;173;164;343;559
00-4-01-04-4395;4;190;141;335;559
00-4-01-04-4397;5;162;176;343;559
00-4-01-04-4398;9;173;169;351;559
00-4-01-04-4399;9;171;156;336;559
00-4-01-05-4401;7;119;100;226;433
00-4-01-05-4402;1;35;56;92;177
00-4-02-01-4403;17;226;180;423;604
00-4-02-01-4404;11;193;210;414;604
00-4-02-01-4405;16;196;186;398;604
00-4-02-01-4406;23;182;207;412;604
00-4-02-01-4407;10;199;216;425;604
00-4-02-01-4408;12;201;218;431;604
00-4-02-01-4409;20;211;187;418;604
00-4-02-01-4410;13;214;217;444;604
00-4-02-01-4411;18;204;205;427;604
00-4-02-01-4412;13;230;207;450;605
00-4-02-02-4413;11;168;209;388;600
00-4-02-02-4414;15;177;222;414;600
00-4-02-02-4415;9;161;207;377;600
00-4-02-02-4416;3;171;202;376;600
00-4-02-02-4417;10;161;199;370;600
00-4-02-02-4418;13;162;230;405;600
00-4-02-02-4419;10;151;212;373;600
00-4-02-02-4420;14;189;215;418;600
00-4-02-02-4421;13;121;234;368;568
00-4-02-02-4422;2;155;198;355;567
00-4-02-02-4423;9;127;232;368;551
00-4-02-02-4424;11;148;199;358;551
00-4-02-02-4425;9;147;202;358;551
00-4-02-02-4426;5;136;182;323;551
00-4-02-02-4427;11;167;181;359;551
00-4-02-02-4428;14;134;179;327;551
00-4-02-03-4429;10;160;199;369;563
00-4-02-03-4430;10;137;229;376;563
00-4-02-03-4431;11;167;201;379;563
00-4-02-03-4432;17;142;225;384;563
00-4-02-03-4433;10;181;181;372;563
00-4-02-03-4434;14;156;186;356;563
00-4-02-03-4435;11;193;161;365;563
00-4-02-03-4436;15;172;185;372;565
00-4-02-03-4437;7;162;178;347;522
00-4-02-03-4438;10;167;184;361;522
00-4-02-03-4439;12;143;211;366;524
00-4-02-04-4440;9;196;163;368;538
00-4-02-04-4441;9;193;195;397;538
00-4-02-04-4443;9;178;179;366;538
00-4-02-04-4444;12;171;187;370;538
00-4-02-04-4445;11;184;208;403;543
00-4-02-05-4446;13;192;213;418;600
00-4-02-05-4447;23;174;227;424;600
00-4-02-05-4448;17;210;177;404;600
00-4-02-05-4449;9;171;245;425;600
00-4-02-05-4450;14;195;217;426;600
00-4-02-05-4451;13;208;178;399;600
00-4-02-05-4452;13;197;202;412;600
00-4-02-05-4453;10;201;188;399;600
00-4-02-05-4454;17;182;178;377;586
00-4-02-05-4455;11;185;211;407;585
00-4-02-06-4456;12;165;169;346;532
00-4-02-06-4457;14;180;171;365;532
00-4-02-06-4458;8;171;173;352;532
00-4-02-06-4459;15;146;188;349;532
00-4-02-06-4460;15;145;170;330;532
00-4-02-06-4461;5;166;187;358;532
00-4-02-06-4462;18;193;172;383;532
00-4-02-06-4465;5;155;124;284;466
00-4-02-06-4466;0;2;4;6;18
00-4-03-01-4467;11;215;164;390;585
00-4-03-01-4468;11;222;167;400;585
00-4-03-01-4469;9;197;195;401;585
00-4-03-01-4470;10;213;176;399;585
00-4-03-01-4471;10;230;158;398;585
00-4-03-01-4472;16;192;181;389;585
00-4-03-01-4473;7;202;178;387;585
00-4-03-01-4474;9;218;169;396;585
00-4-03-01-4475;14;208;182;404;585
00-4-03-01-4477;15;205;182;402;585
00-4-03-01-4478;12;231;148;391;585
00-4-03-01-4479;16;195;193;404;589
00-4-03-02-4480;14;220;162;396;557
00-4-03-02-4481;17;228;148;393;557
00-4-03-02-4482;19;229;167;415;557
00-4-03-02-4483;14;233;143;390;557
00-4-03-02-4484;17;217;156;390;557
00-4-03-02-4485;13;236;157;406;557
00-4-03-02-4486;18;205;170;393;557
00-4-03-02-4487;8;212;180;400;557
00-4-03-02-4488;9;214;181;404;563
00-4-03-03-4489;10;170;174;354;543
00-4-03-03-4490;14;182;183;379;543
00-4-03-03-4491;12;188;183;383;543
00-4-03-03-4492;13;171;178;362;543
00-4-03-03-4493;11;170;189;370;543
00-4-03-03-4494;12;186;187;385;547
00-4-03-03-4495;12;140;117;269;365
00-4-03-03-4496;8;135;136;279;366
00-4-03-03-4497;9;141;195;345;506
00-4-03-03-4498;11;145;188;344;506
00-4-03-03-4499;12;138;197;347;507
00-4-03-04-4500;7;156;180;343;568
00-4-03-04-4501;11;165;154;330;568
00-4-03-04-4502;17;167;161;345;568
00-4-03-04-4503;11;146;217;374;571
00-4-03-05-4504;14;204;164;382;545
00-4-03-05-4505;7;195;183;385;545
00-4-03-05-4506;15;215;147;377;545
00-4-03-05-4507;14;202;151;367;545
00-4-03-05-4508;15;185;172;372;545
00-4-03-05-4509;16;192;168;376;545
00-4-03-05-4510;12;186;177;375;545
00-4-03-05-4511;16;220;160;396;551
00-4-03-06-4512;12;198;164;374;551
00-4-03-06-4513;10;152;173;335;551
00-4-03-06-4514;10;179;169;358;551
00-4-03-06-4515;6;148;186;340;551
00-4-03-06-4516;9;168;183;360;551
00-4-03-06-4517;10;161;178;349;551
00-4-03-06-4518;13;146;196;355;551
00-4-03-06-4519;10;168;164;342;551
00-4-03-06-4520;15;162;179;356;551
00-4-03-06-4521;13;186;170;369;552
00-4-03-07-4522;4;148;150;302;521
00-4-03-07-4523;7;156;200;363;521
00-4-03-07-4524;14;158;165;337;521
00-4-03-07-4525;7;153;162;322;521
00-4-03-07-4526;11;155;180;346;521
00-4-03-07-4527;7;204;148;359;521
00-4-03-08-4528;11;132;221;364;555
00-4-03-08-4529;7;187;170;364;555
00-4-03-08-4530;14;153;184;351;555
00-4-03-08-4531;9;171;187;367;555
00-4-03-08-4532;5;182;199;386;557
00-4-04-01-4533;8;195;200;403;585
00-4-04-01-4534;10;168;198;376;585
00-4-04-01-4535;9;183;182;374;585
00-4-04-01-4536;11;166;209;386;585
00-4-04-01-4537;8;149;227;384;585
00-4-04-01-4538;11;165;171;347;585
00-4-04-01-4539;10;167;186;363;585
00-4-04-01-4540;8;179;209;396;585
00-4-04-01-4541;6;172;215;393;585
00-4-04-01-4542;4;171;217;392;585
00-4-04-01-4543;6;140;217;363;585
00-4-04-01-4544;11;178;205;394;594
00-4-04-02-4545;8;179;204;391;557
00-4-04-02-4546;9;133;189;331;557
00-4-04-02-4547;6;172;181;359;557
00-4-04-02-4548;12;173;169;354;557
00-4-04-02-4549;9;193;173;375;557
00-4-04-02-4550;7;146;210;363;561
00-4-04-03-4551;8;143;248;399;569
00-4-04-03-4552;13;144;209;366;569
00-4-04-03-4553;11;170;201;382;569
00-4-04-03-4554;10;159;231;400;569
00-4-04-03-4555;9;172;212;393;569
00-4-04-03-4556;10;174;207;391;569
00-4-04-03-4557;12;166;192;370;569
00-4-04-03-4558;11;170;213;394;569
00-4-04-03-4560;5;180;230;415;577
00-4-04-04-4561;7;169;200;376;600
00-4-04-04-4562;8;155;222;385;600
00-4-04-04-4563;8;173;186;367;600
00-4-04-04-4564;10;144;229;383;592
00-4-04-04-4565;9;183;202;394;592
00-4-04-04-4566;7;168;177;352;600
00-4-04-04-4567;12;178;178;368;600
00-4-04-04-4568;12;133;196;341;600
00-4-04-04-4569;10;156;176;342;600
00-4-04-04-4570;12;168;186;366;596
00-4-04-04-4571;9;144;210;363;596
00-4-04-05-4572;16;160;170;346;544
00-4-04-05-4573;9;165;161;335;544
00-4-04-05-4574;12;177;145;334;544
00-4-04-05-4575;2;94;114;210;336
00-4-04-05-4576;5;110;122;237;337
00-4-04-05-4577;2;51;18;71;111
00-4-04-06-4578;11;116;134;261;410
00-4-04-06-4579;5;119;147;271;410
00-4-04-06-4580;2;135;133;270;412
00-4-04-06-4581;19;170;172;361;579
00-4-04-06-4582;6;195;161;362;579
00-4-04-06-4583;8;189;186;383;579
00-4-04-06-4584;15;169;179;363;581
00-4-05-01-4585;8;181;199;388;611
00-4-05-01-4586;13;161;197;371;611
00-4-05-01-4587;9;161;216;386;611
00-4-05-01-4588;9;188;190;387;611
00-4-05-01-4589;10;160;214;384;611
00-4-05-01-4590;9;175;205;389;611
00-4-05-01-4591;18;178;217;413;611
00-4-05-01-4592;15;168;222;405;611
00-4-05-01-4593;14;172;177;363;611
00-4-05-01-4594;3;197;205;405;611
00-4-05-01-4595;14;190;186;390;611
00-4-05-01-4596;8;205;185;398;611
00-4-05-01-4597;7;182;210;399;611
00-4-05-01-4598;7;194;187;388;611
00-4-05-01-4599;19;177;192;388;611
00-4-05-01-4600;9;177;212;398;621
00-4-05-02-4601;11;159;185;355;584
00-4-05-02-4602;10;135;176;321;584
00-4-05-02-4603;11;134;214;359;584
00-4-05-02-4604;6;152;185;343;584
00-4-05-02-4605;9;151;179;339;584
00-4-05-02-4606;5;144;174;323;584
00-4-05-02-4607;6;145;187;338;584
00-4-05-02-4608;14;145;169;328;584
00-4-05-02-4609;11;145;183;339;584
00-4-05-02-4610;12;137;186;335;584
00-4-05-02-4611;9;150;188;347;584
00-4-05-02-4612;11;152;172;335;584
00-4-05-02-4613;10;152;190;352;584
00-4-05-02-4614;7;140;180;327;587
00-4-05-03-4615;15;157;190;362;585
00-4-05-03-4616;16;159;190;365;585
00-4-05-03-4617;11;183;178;372;585
00-4-05-03-4618;16;145;190;351;585
00-4-05-03-4619;16;159;164;339;585
00-4-05-03-4620;8;160;182;350;585
00-4-05-03-4621;15;161;194;370;585
00-4-05-03-4622;10;190;208;408;592
00-4-05-03-4623;23;164;191;378;565
00-4-05-03-4624;14;185;169;368;565
00-4-05-03-4625;16;145;216;377;567
00-4-05-04-4626;7;210;210;427;609
00-4-05-04-4627;14;208;207;429;609
00-4-05-04-4628;11;196;190;397;609
00-4-05-04-4629;13;176;204;393;609
00-4-05-04-4630;14;200;181;395;609
00-4-05-04-4631;15;236;196;447;609
00-4-05-04-4632;8;221;176;405;609
00-4-05-04-4633;13;236;189;438;616
00-4-05-04-4634;12;131;162;305;519
00-4-05-04-4635;9;142;175;326;519
00-4-05-04-4636;12;115;164;291;519
00-4-05-04-4637;12;136;160;308;519
00-4-05-04-4638;13;176;138;327;519
00-4-05-04-4639;2;120;117;239;352
00-4-05-04-4640;9;122;84;215;353
00-4-05-04-4641;7;106;153;266;485
00-4-05-04-4642;12;99;155;266;485
00-4-05-04-4644;6;113;168;287;487
00-4-05-05-4645;11;152;170;333;546
00-4-05-05-4646;10;178;182;370;546
00-4-05-05-4647;11;170;188;369;546
00-4-05-05-4648;8;140;197;345;546
00-4-05-05-4649;16;158;188;362;546
00-4-05-05-4650;9;165;164;338;546
00-4-05-05-4651;13;178;167;358;549
00-4-06-01-4652;11;205;154;370;591
00-4-06-01-4653;10;168;187;365;591
00-4-06-01-4654;11;172;196;379;591
00-4-06-01-4655;11;193;194;398;591
00-4-06-01-4656;10;163;183;356;591
00-4-06-01-4657;7;215;187;409;591
00-4-06-01-4658;11;158;200;369;591
00-4-06-01-4659;12;173;194;379;591
00-4-06-01-4660;11;192;176;379;591
00-4-06-01-4661;13;189;194;396;591
00-4-06-01-4662;11;184;191;386;591
00-4-06-01-4663;9;204;203;416;591
00-4-06-01-4664;4;209;188;401;591
00-4-06-01-4665;10;216;190;416;600
00-4-06-02-4666;9;232;161;402;578
00-4-06-02-4667;3;217;164;384;578
00-4-06-02-4668;9;203;164;376;578
00-4-06-02-4669;8;222;159;389;578
00-4-06-02-4670;8;235;137;380;578
00-4-06-02-4671;14;207;184;405;579
00-4-06-02-4672;11;154;152;317;488
00-4-06-02-4673;8;172;128;308;488
00-4-06-02-4674;1;7;4;12;17
00-4-06-02-4675;1;6;7;14;66
00-4-06-03-4676;6;182;147;335;519
00-4-06-03-4677;8;180;144;332;519
00-4-06-03-4678;8;172;167;347;521
00-4-06-03-4679;14;108;114;236;376
00-4-06-03-4680;4;134;95;233;377
00-4-06-04-4681;5;120;173;298;483
00-4-06-04-4682;5;133;161;299;483
00-4-06-04-4683;9;127;176;312;483
00-4-06-04-4684;5;144;170;319;485
00-4-06-04-4685;1;54;64;119;179
00-4-07-01-4686;9;194;186;389;588
00-4-07-01-4687;9;184;194;387;588
00-4-07-01-4688;4;173;192;369;588
00-4-07-01-4689;5;184;212;401;588
00-4-07-01-4690;4;214;144;362;588
00-4-07-01-4691;12;200;182;394;588
00-4-07-01-4692;7;184;170;361;588
00-4-07-01-4693;16;149;194;359;588
00-4-07-01-4694;7;197;209;413;588
00-4-07-01-4695;8;160;177;345;588
00-4-07-01-4696;7;195;211;413;588
00-4-07-01-4697;4;205;170;379;588
00-4-07-01-4698;9;167;190;366;588
00-4-07-01-4700;9;255;180;444;600
00-4-07-02-4701;2;197;194;393;564
00-4-07-02-4702;11;212;178;401;564
00-4-07-02-4703;5;193;167;365;564
00-4-07-02-4704;6;185;193;384;564
00-4-07-02-4705;8;197;169;374;564
00-4-07-02-4706;1;196;171;368;564
00-4-07-02-4707;5;208;170;383;564
00-4-07-02-4708;13;189;165;367;564
00-4-07-02-4709;5;199;186;390;564
00-4-07-02-4710;11;215;160;386;564
00-4-07-02-4711;12;191;162;365;564
00-4-07-02-4712;7;253;154;414;568
00-4-07-03-4713;7;249;174;430;600
00-4-07-03-4714;8;226;191;425;600
00-4-07-03-4715;11;222;202;435;600
00-4-07-03-4716;9;215;176;400;600
00-4-07-03-4717;14;261;148;423;600
00-4-07-03-4718;11;212;177;400;567
00-4-07-03-4719;11;230;178;419;567
00-4-08-01-4720;7;206;201;414;612
00-4-08-01-4721;13;222;207;442;612
00-4-08-01-4722;6;228;198;432;612
00-4-08-01-4723;9;224;192;425;612
00-4-08-01-4724;10;198;196;404;612
00-4-08-01-4725;11;195;199;405;612
00-4-08-01-4726;9;200;220;429;612
00-4-08-01-4727;13;215;184;412;612
00-4-08-01-4728;10;218;184;412;612
00-4-08-01-4729;14;212;201;427;612
00-4-08-01-4730;18;187;223;428;612
00-4-08-01-4731;13;190;208;411;612
00-4-08-01-4732;9;217;185;411;612
00-4-08-01-4733;13;196;207;416;612
00-4-08-01-4734;11;218;235;464;625
00-4-08-02-4735;6;258;223;487;613
00-4-08-02-4736;9;230;217;456;613
00-4-08-02-4737;8;260;196;464;613
00-4-08-02-4738;7;238;221;466;613
00-4-08-02-4739;7;236;222;465;617
00-4-08-03-4740;14;187;170;371;581
00-4-08-03-4741;8;156;196;360;581
00-4-08-03-4742;12;167;188;367;581
00-4-08-03-4743;11;170;176;357;581
00-4-08-03-4744;11;173;201;385;581
00-4-08-03-4745;5;169;175;349;581
00-4-08-03-4748;8;177;193;378;581
00-4-08-03-4749;6;216;174;396;584
00-4-09-01-4750;2;206;185;393;603
00-4-09-01-4752;15;197;189;401;603
00-4-09-01-4753;15;195;174;384;603
00-4-09-01-4754;7;224;178;409;603
00-4-09-01-4755;5;181;185;371;603
00-4-09-01-4756;19;193;165;377;603
00-4-09-01-4757;14;209;157;380;603
00-4-09-01-4758;19;210;182;411;603
00-4-09-01-4759;11;201;175;387;603
00-4-09-01-4760;12;188;200;400;603
00-4-09-01-4761;6;214;174;394;603
00-4-09-01-4762;7;199;175;381;603
00-4-09-01-4763;9;180;187;376;603
00-4-09-01-4764;13;200;164;377;603
00-4-09-01-4765;11;195;184;390;603
00-4-09-01-4766;8;193;184;385;603
00-4-09-01-4767;10;200;179;389;603
00-4-09-01-4768;13;219;145;377;603
00-4-09-01-4769;13;188;182;383;603
00-4-09-01-4770;6;203;201;410;603
00-4-09-01-4771;13;208;197;418;603
00-4-09-01-4772;9;191;204;404;603
00-4-09-01-4773;10;210;175;395;603
00-4-09-01-4774;14;177;198;389;603
00-4-09-01-4775;8;200;168;376;603
00-4-09-01-4776;12;186;203;401;603
00-4-09-01-4777;11;177;182;370;603
00-4-09-01-4778;12;231;182;425;626
00-4-09-02-4779;10;189;192;391;581
00-4-09-02-4780;12;174;200;386;581
00-4-09-02-4781;11;166;208;385;581
00-4-09-02-4782;13;193;194;400;584
00-4-09-02-4783;8;216;184;408;600
00-4-09-02-4784;12;188;202;402;600
00-4-09-02-4785;14;232;143;389;600
00-4-09-02-4786;10;216;163;389;600
00-4-09-02-4787;9;214;178;401;600
00-4-09-02-4788;14;188;198;400;600
00-4-09-02-4789;24;15;12;51;51
00-4-10-01-4790;6;159;172;337;612
00-4-10-01-4791;8;142;158;308;612
00-4-10-01-4793;6;118;158;282;615
00-4-10-01-4794;0;5;7;12;38
00-4-10-01-4795;0;28;11;39;111
00-4-10-01-4796;7;79;146;232;546
00-4-10-01-4797;10;66;139;215;546
00-4-10-01-4798;3;83;147;233;546
00-4-10-01-4799;7;65;151;223;547
00-4-10-01-4800;3;64;132;199;407
00-4-10-01-4801;3;37;54;94;149
00-4-10-01-4802;6;66;96;168;376
00-4-10-01-4803;2;57;64;123;376
00-4-10-01-4804;7;98;108;213;600
00-4-10-01-4805;7;94;110;211;600
00-4-10-01-4806;6;87;136;229;649
00-4-10-01-4807;4;83;144;231;582
00-4-10-01-4808;7;101;151;259;600
00-4-10-01-4809;6;116;164;286;600
00-4-10-01-4811;4;44;58;106;189
00-4-10-01-4812;2;76;118;196;498
00-4-10-01-4813;4;72;126;202;499
00-4-10-02-4814;6;104;180;290;520
00-4-10-02-4815;11;123;177;311;520
00-4-10-02-4816;8;118;153;279;520
00-4-10-02-4817;4;104;157;265;520
00-4-10-02-4818;8;120;163;291;520
00-4-10-02-4819;7;113;159;279;522
00-4-10-02-4820;3;52;71;126;220
00-4-10-02-4821;4;57;40;101;174
00-4-10-02-4822;10;187;151;348;555
00-4-10-02-4823;3;33;48;84;140
00-4-10-02-4824;4;59;92;155;349
00-4-10-02-4825;4;74;82;160;350
00-4-10-02-4826;4;72;157;233;423
00-4-10-02-4827;6;51;160;217;424
00-4-10-02-4828;2;19;38;59;159
00-4-10-02-4829;2;10;13;25;58
00-4-10-02-4830;2;55;82;139;278
00-4-10-02-4831;0;12;4;16;23
00-4-10-02-4832;5;139;149;293;538
00-4-10-03-4833;9;117;164;290;600
00-4-10-03-4834;10;140;170;320;600
00-4-10-03-4835;6;113;186;305;600
00-4-10-03-4836;10;114;153;277;574
00-4-10-03-4837;12;119;155;286;574
00-4-10-03-4838;5;95;181;281;547
00-4-10-03-4839;7;100;189;296;547
00-4-10-03-4840;6;78;174;258;547
00-4-10-03-4841;4;108;182;294;547
00-4-10-03-4842;2;125;162;289;547
00-4-10-03-4843;5;94;178;277;547
00-4-10-03-4844;8;111;189;308;552
00-4-10-03-4845;5;108;126;239;520
00-4-10-03-4846;4;103;154;261;521
00-4-10-03-4847;6;156;176;338;590
00-4-10-03-4848;2;70;166;238;431
00-4-10-03-4849;5;80;174;259;431
00-4-10-03-4850;10;76;151;237;432
00-4-10-03-4852;10;127;198;335;616
00-4-10-03-4853;5;107;153;265;418
00-4-10-03-4854;1;7;41;49;81
00-4-10-03-4855;6;117;163;286;517
00-4-10-03-4856;7;88;181;276;517
00-4-10-03-4857;4;114;150;268;517
00-4-10-03-4858;4;85;198;287;517
00-4-10-03-4859;8;85;189;282;521
00-4-10-03-4860;2;23;65;90;186
00-4-10-03-4861;1;63;142;206;337
00-4-10-03-4862;6;69;119;194;337
00-4-10-03-4863;1;75;143;219;435
00-4-10-03-4864;6;86;107;199;387
00-4-10-03-4865;5;71;109;185;387
00-4-10-03-4866;5;83;104;192;322
00-4-10-03-4867;12;91;171;274;545
00-4-10-03-4868;9;112;242;363;578
00-4-10-03-4869;7;35;71;113;204
00-4-10-03-4870;3;48;99;150;275
00-4-10-04-4871;0;37;126;163;447
00-4-10-05-4872;0;48;39;87;182
00-4-10-05-4873;0;33;23;56;189
00-5-01-01-4874;6;183;150;339;584
00-5-01-01-4875;7;139;168;314;584
00-5-01-01-4876;3;141;165;309;584
00-5-01-01-4877;8;153;167;328;584
00-5-01-01-4878;7;151;163;321;584
00-5-01-01-4879;7;172;146;325;584
00-5-01-01-4880;5;152;154;311;584
00-5-01-01-4881;5;173;153;331;584
00-5-01-01-4882;3;183;165;351;584
00-5-01-01-4883;7;163;160;330;584
00-5-01-01-4884;8;161;156;325;587
00-5-01-01-4885;1;93;92;186;402
00-5-01-01-4886;3;88;73;164;402
00-5-01-01-4887;1;53;22;76;256
00-5-01-01-4888;0;1;13;14;26
00-5-01-01-4889;3;96;103;202;494
00-5-01-01-4890;8;99;111;218;494
00-5-01-01-4891;10;112;110;232;495
00-5-01-01-4892;3;94;132;229;600
00-5-01-01-4893;2;109;122;233;600
00-5-01-01-4895;6;101;137;244;600
00-5-01-01-4896;10;98;140;248;600
00-5-01-01-4897;7;95;118;220;600
00-5-01-01-4898;7;70;145;222;600
00-5-01-01-4899;6;94;111;211;600
00-5-01-01-4900;0;97;117;214;600
00-5-01-01-4901;8;108;120;236;607
00-5-01-01-4902;5;125;161;291;572
00-5-01-01-4903;7;121;167;295;572
00-5-01-01-4904;8;120;186;314;572
00-5-01-01-4905;3;146;161;310;572
00-5-01-01-4906;7;124;147;278;572
00-5-01-01-4907;9;141;173;323;572
00-5-01-01-4908;7;143;169;319;572
00-5-01-01-4909;11;101;154;266;572
00-5-01-01-4910;11;125;164;300;572
00-5-01-01-4911;1;134;166;301;572
00-5-01-01-4912;10;147;161;318;574
00-5-01-01-4913;5;101;138;244;644
00-5-01-01-4914;7;110;168;285;644
00-5-01-01-4915;1;109;148;258;644
00-5-01-01-4916;7;150;140;297;644
00-5-01-01-4917;4;103;159;266;644
00-5-01-01-4918;8;103;118;229;644
00-5-01-01-4919;2;111;131;244;644
00-5-01-01-4920;4;122;130;256;644
00-5-01-01-4921;4;127;130;261;644
00-5-01-01-4922;4;116;141;261;644
00-5-01-01-4923;4;110;145;259;644
00-5-01-01-4924;8;108;131;247;644
00-5-01-01-4925;5;102;150;257;644
00-5-01-01-4926;5;97;127;229;644
00-5-01-01-4927;5;138;142;285;644
00-5-01-01-4928;3;119;151;273;644
00-5-01-01-4929;11;132;152;295;644
00-5-01-01-4930;6;129;134;269;644
00-5-01-01-4931;6;127;151;284;644
00-5-01-01-4932;3;13;9;25;63
00-5-01-01-4933;3;56;51;110;245
00-5-01-01-4934;2;134;184;320;609
00-5-01-01-4935;4;136;161;301;609
00-5-01-01-4936;6;128;177;311;609
00-5-01-01-4937;8;131;182;321;609
00-5-01-01-4938;11;125;162;298;609
00-5-01-01-4939;9;111;186;306;609
00-5-01-01-4940;7;144;182;333;609
00-5-01-01-4941;7;133;181;321;609
00-5-01-01-4942;8;152;177;337;611
00-5-01-01-4943;8;38;24;70;227
00-5-01-01-4944;5;120;159;284;535
00-5-01-01-4945;5;154;154;313;535
00-5-01-01-4946;6;119;138;263;535
00-5-01-01-4947;5;144;145;294;535
00-5-01-01-4948;2;38;34;74;152
00-5-01-02-4949;5;119;127;251;454
00-5-01-02-4950;5;98;153;256;454
00-5-01-02-4951;7;100;150;257;454
00-5-01-02-4952;4;130;105;239;525
00-5-01-02-4953;3;90;102;195;388
00-5-01-02-4954;3;26;46;75;132
00-5-01-03-4955;5;188;98;291;558
00-5-01-03-4956;5;160;99;264;558
00-5-01-04-4957;1;131;153;285;616
00-5-01-04-4958;5;136;136;277;616
00-5-01-04-4959;7;132;140;279;617
00-5-01-05-4960;9;93;108;210;430
00-5-01-05-4961;8;140;120;268;557
00-5-01-05-4962;14;137;115;266;557
00-5-01-05-4963;8;101;108;217;418
00-5-02-01-4964;10;165;205;380;610
00-5-02-01-4965;10;186;173;369;610
00-5-02-01-4966;10;173;200;383;610
00-5-02-01-4967;4;153;196;353;610
00-5-02-01-4968;13;144;185;342;610
00-5-02-01-4969;11;166;169;346;610
00-5-02-01-4970;2;180;187;369;610
00-5-02-01-4971;8;170;179;357;610
00-5-02-01-4972;7;138;204;349;610
00-5-02-01-4973;9;165;182;356;610
00-5-02-01-4974;9;150;204;363;610
00-5-02-01-4975;5;172;213;390;610
00-5-02-01-4976;6;168;195;369;610
00-5-02-01-4977;13;160;198;371;610
00-5-02-01-4978;3;99;109;211;408
00-5-02-01-4979;14;100;150;264;515
00-5-02-01-4980;3;51;87;141;405
00-5-02-01-4981;6;105;167;278;575
00-5-02-01-4982;3;139;177;319;575
00-5-02-01-4983;3;104;169;276;575
00-5-02-01-4984;4;102;150;256;575
00-5-02-01-4985;5;130;144;279;575
00-5-02-01-4986;11;125;130;266;575
00-5-02-01-4987;7;110;150;267;575
00-5-02-01-4988;1;89;152;242;575
00-5-02-01-4989;5;105;186;296;575
00-5-02-01-4991;6;103;131;240;428
00-5-02-01-4992;6;108;150;264;459
00-5-02-01-4993;4;87;189;280;460
00-5-02-01-4995;3;78;99;180;381
00-5-02-01-4996;2;39;21;62;104
00-5-02-01-4997;2;51;47;100;232
00-5-02-01-4998;9;95;139;243;440
00-5-02-01-4999;0;43;28;71;179
00-5-02-01-5000;5;103;161;269;517
00-5-02-01-5001;12;92;142;246;517
00-5-02-01-5002;9;115;134;258;468
00-5-02-01-5003;14;131;142;287;469
00-5-02-01-5004;0;16;14;30;58
00-5-02-01-5005;5;106;107;218;409
00-5-02-01-5006;2;80;88;170;354
00-5-02-01-5007;4;89;97;190;355
00-5-02-01-5008;1;26;26;53;97
00-5-02-01-5009;0;5;7;12;22
00-5-02-01-5010;5;135;55;195;423
00-5-02-02-5011;2;78;57;137;351
00-5-02-02-5012;4;76;63;143;352
00-5-02-02-5013;4;143;123;270;505
00-5-02-02-5014;3;156;131;290;505
00-5-02-02-5015;3;187;104;294;507
00-5-02-02-5016;1;25;23;49;72
00-5-02-02-5017;6;137;145;288;501
00-5-02-02-5018;5;112;169;286;468
00-5-02-02-5019;2;73;40;115;244
00-5-02-02-5020;4;120;129;253;398
00-5-02-02-5021;0;43;51;94;201
00-5-02-02-5022;10;108;52;170;312
00-5-02-03-5023;2;113;114;229;385
00-5-02-03-5024;2;91;99;192;385
00-5-02-03-5025;4;88;119;211;445
00-5-02-03-5026;7;89;105;201;446
00-5-02-03-5027;3;59;52;114;177
00-5-02-03-5028;3;130;76;209;359
00-5-02-03-5029;8;86;158;252;545
00-5-02-03-5030;5;82;56;143;262
00-5-02-03-5031;5;122;147;274;478
00-5-02-03-5032;2;46;64;112;169
00-5-02-03-5033;6;87;103;196;387
00-5-02-03-5034;7;76;71;154;333
00-5-02-03-5035;3;101;88;192;333
00-5-02-03-5036;4;49;84;137;264
00-5-02-03-5037;1;54;20;75;125
00-5-02-03-5038;5;109;99;213;344
00-5-02-03-5039;0;43;45;88;178
00-5-02-03-5040;0;22;24;46;88
00-5-02-04-5041;3;95;58;156;313
00-5-02-04-5042;2;92;106;200;346
00-5-02-04-5043;7;71;105;183;346
00-5-02-04-5044;3;101;145;249;374
00-5-02-04-5045;1;62;39;102;134
00-5-02-04-5046;2;81;73;156;285
00-5-02-04-5047;2;116;170;288;459
00-5-02-05-5048;10;64;94;168;383
00-5-02-05-5049;2;62;111;175;340
00-5-02-05-5050;9;66;134;209;483
00-5-02-05-5051;2;91;96;189;483
00-5-02-05-5052;8;71;105;184;483
00-5-02-05-5053;3;63;101;167;437
00-5-02-05-5054;2;17;15;34;97
00-5-02-05-5055;0;30;31;61;115
00-5-02-06-5056;12;84;165;261;600
00-5-02-06-5057;9;77;123;209;600
00-5-02-06-5058;12;96;125;233;600
00-5-02-06-5059;12;99;121;232;594
00-5-02-06-5060;8;64;135;207;594
00-5-02-06-5061;0;16;4;20;65
00-5-02-06-5062;7;53;46;106;264
00-5-02-06-5063;9;101;121;231;536
00-5-02-06-5064;7;40;34;81;200
00-5-02-07-5065;3;54;40;97;205
00-5-02-07-5066;4;56;65;125;263
00-5-02-07-5067;9;85;53;147;255
00-5-02-07-5068;4;70;56;130;202
00-5-02-07-5069;2;114;138;254;455
00-5-02-07-5070;4;132;130;266;455
00-5-02-07-5071;4;68;70;142;217
00-5-02-07-5072;1;12;7;20;62
00-5-02-07-5073;3;23;19;45;75
00-5-03-01-5074;9;119;170;298;609
00-5-03-01-5075;12;130;215;357;609
00-5-03-01-5076;9;126;202;337;609
00-5-03-01-5077;7;123;183;313;609
00-5-03-01-5078;7;112;193;312;609
00-5-03-01-5079;6;118;180;304;609
00-5-03-01-5080;7;129;172;308;609
00-5-03-01-5081;8;146;148;302;609
00-5-03-01-5082;1;125;182;308;609
00-5-03-01-5083;5;139;175;319;609
00-5-03-01-5084;7;149;195;351;609
00-5-03-01-5085;11;117;181;309;609
00-5-03-01-5086;6;124;132;262;609
00-5-03-01-5087;9;136;190;335;609
00-5-03-01-5088;16;124;182;322;609
00-5-03-01-5089;5;112;190;307;609
00-5-03-01-5090;9;144;158;311;609
00-5-03-01-5091;6;148;158;312;609
00-5-03-01-5092;7;112;191;310;609
00-5-03-01-5093;6;133;174;313;624
00-5-03-01-5094;8;117;129;254;485
00-5-03-01-5095;2;115;148;265;485
00-5-03-01-5096;7;100;152;259;486
00-5-03-01-5097;4;82;156;242;508
00-5-03-01-5098;11;85;167;263;508
00-5-03-01-5099;2;76;126;204;389
00-5-03-01-5100;1;73;132;206;390
00-5-03-01-5101;10;125;172;307;603
00-5-03-01-5102;4;68;113;185;456
00-5-03-01-5103;5;73;118;196;457
00-5-03-01-5104;0;3;8;11;38
00-5-03-01-5105;4;82;120;206;379
00-5-03-01-5106;7;66;120;193;380
00-5-03-01-5107;9;108;172;289;492
00-5-03-01-5108;0;3;1;4;14
00-5-03-01-5109;9;127;202;338;638
00-5-03-02-5110;3;139;63;205;395
00-5-03-02-5111;17;145;134;296;494
00-5-03-02-5112;7;132;120;259;494
00-5-03-03-5113;13;113;165;291;616
00-5-03-03-5114;3;129;138;270;616
00-5-03-03-5115;7;76;165;248;558
00-5-03-03-5116;4;90;138;232;558
00-5-03-03-5117;6;88;136;230;560
00-5-03-03-5118;6;49;132;187;447
00-5-03-03-5119;3;87;116;206;427
00-5-03-03-5120;2;55;113;170;361
00-5-03-03-5121;2;50;101;153;361
00-5-03-03-5122;12;64;91;167;378
00-5-03-03-5123;1;38;30;69;188
00-5-03-03-5124;1;11;32;44;91
00-5-03-03-5125;3;86;102;191;446
00-5-03-04-5126;6;148;107;261;540
00-5-03-04-5127;6;81;135;222;442
00-5-03-04-5128;5;111;126;242;443
00-5-03-04-5129;3;58;115;176;488
00-5-03-04-5130;5;54;118;177;488
00-5-03-04-5131;12;113;155;280;612
00-5-03-04-5132;4;53;145;202;420
00-5-03-04-5133;24;55;140;219;421
00-5-03-05-5134;8;92;212;312;567
00-5-03-05-5135;6;95;181;282;567
00-5-03-05-5136;1;91;210;302;567
00-5-03-05-5137;5;98;195;298;567
00-5-03-05-5138;7;108;168;283;567
00-5-03-05-5139;4;61;77;142;336
00-5-03-06-5140;6;79;117;202;448
00-5-03-06-5142;8;50;118;176;436
00-5-03-06-5143;1;73;20;94;151
00-5-03-06-5144;0;2;18;20;39
00-5-03-06-5145;0;10;5;15;48
00-5-03-07-5146;5;110;195;310;525
00-5-03-07-5147;6;97;195;298;525
00-5-03-07-5148;11;90;189;290;525
00-5-03-07-5149;4;68;198;270;525
00-5-03-07-5150;3;63;125;191;382
00-5-03-07-5151;4;60;90;154;373
00-5-03-07-5152;9;86;185;280;509
00-5-03-08-5153;6;96;126;228;480
00-5-03-08-5154;3;109;129;241;480
00-5-03-08-5155;4;119;104;227;481
00-5-03-08-5156;5;82;120;207;459
00-5-03-08-5157;5;93;93;191;459
00-5-03-09-5158;4;87;146;237;549
00-5-03-09-5159;5;98;133;236;549
00-5-03-09-5160;6;95;134;235;549
00-5-03-09-5161;5;124;121;250;549
00-5-03-09-5162;7;117;136;260;553
00-5-03-09-5163;3;78;127;208;418
00-5-03-09-5164;4;74;145;223;419
00-5-03-09-5165;5;108;125;238;578
00-5-03-09-5166;3;114;147;264;450
00-5-04-01-5167;2;122;154;278;608
00-5-04-01-5168;9;97;153;259;608
00-5-04-01-5169;4;110;138;252;608
00-5-04-01-5170;4;124;154;282;608
00-5-04-01-5171;4;138;149;291;608
00-5-04-01-5172;11;119;155;285;608
00-5-04-01-5173;7;102;175;284;608
00-5-04-01-5174;8;149;184;341;608
00-5-04-01-5175;4;110;138;252;611
00-5-04-01-5176;1;66;51;118;236
00-5-04-01-5177;6;31;42;79;181
00-5-04-01-5178;1;23;48;72;133
00-5-04-01-5179;1;56;70;127;335
00-5-04-01-5180;2;68;81;151;335
00-5-04-01-5181;2;87;114;203;637
00-5-04-01-5182;4;98;144;246;638
00-5-04-01-5183;1;57;43;101;227
00-5-04-01-5184;4;52;50;106;285
00-5-04-01-5185;6;46;60;112;311
00-5-04-02-5186;2;9;41;52;76
00-5-04-02-5187;5;111;211;327;598
00-5-04-02-5188;4;106;214;324;598
00-5-04-02-5189;7;104;206;317;599
00-5-04-02-5190;2;101;142;245;430
00-5-04-03-5191;3;82;198;283;528
00-5-04-03-5192;5;65;227;297;528
00-5-04-03-5193;11;94;218;323;528
00-5-04-03-5194;6;71;187;264;528
00-5-04-03-5195;6;80;240;326;528
00-5-04-03-5196;2;39;68;109;210
00-5-04-03-5197;1;32;26;59;117
00-5-04-04-5198;4;80;90;174;333
00-5-04-04-5199;6;75;90;171;333
00-5-04-04-5200;4;74;39;117;173
00-5-05-01-5201;6;131;167;304;574
00-5-05-01-5202;4;142;170;316;574
00-5-05-01-5203;7;133;155;295;574
00-5-05-01-5204;0;132;160;292;574
00-5-05-01-5205;6;100;137;243;574
00-5-05-01-5206;6;126;150;282;574
00-5-05-01-5207;21;130;165;316;574
00-5-05-01-5208;4;124;160;288;574
00-5-05-01-5209;6;138;125;269;579
00-5-05-01-5210;1;36;49;86;205
00-5-05-01-5211;10;37;71;118;334
00-5-05-01-5212;2;42;59;103;334
00-5-05-02-5213;0;97;118;215;452
00-5-05-02-5214;3;75;129;207;452
00-5-05-02-5215;2;96;85;183;453
00-5-05-02-5216;2;112;180;294;625
00-5-05-02-5217;2;153;154;309;626
00-5-05-02-5218;8;126;167;301;525
00-5-05-02-5219;3;138;148;289;525
00-5-05-03-5220;4;119;161;284;556
00-5-05-03-5221;9;94;153;256;556
00-5-05-03-5222;4;86;164;254;556
00-5-05-03-5223;13;84;144;241;556
00-5-05-03-5224;5;92;157;254;556
00-5-05-03-5225;9;99;161;269;556
00-5-05-03-5226;4;98;139;241;556
00-5-05-03-5227;1;105;109;215;474
00-5-05-03-5228;2;113;122;237;474
00-5-05-03-5229;9;133;165;307;623
00-5-05-03-5231;2;81;189;272;650
00-5-05-03-5232;3;100;161;264;650
00-5-05-03-5233;3;89;176;268;650
00-5-05-03-5234;1;97;165;263;651
00-5-05-03-5235;5;95;116;216;493
00-5-05-03-5236;5;31;41;77;193
00-5-05-03-5237;3;54;129;186;514
00-5-05-03-5238;4;88;98;190;469
00-5-05-03-5239;0;13;16;29;64
00-5-05-04-5240;6;91;125;222;559
00-5-05-04-5241;9;106;118;233;559
00-5-05-04-5242;5;102;140;247;559
00-5-05-04-5243;4;101;122;227;559
00-5-05-04-5244;9;84;115;208;559
00-5-05-04-5245;3;110;126;239;561
00-5-05-04-5246;6;111;135;252;603
00-5-05-04-5247;7;106;109;222;604
00-5-05-04-5248;4;106;106;216;434
00-5-05-04-5249;3;90;62;155;323
00-5-05-04-5250;10;183;136;329;570
00-5-05-04-5251;4;79;49;132;251
00-5-05-04-5252;2;54;102;158;332
00-5-06-01-5253;4;134;167;305;604
00-5-06-01-5254;5;116;148;269;604
00-5-06-01-5255;4;111;185;300;604
00-5-06-01-5256;5;111;154;270;604
00-5-06-01-5257;3;123;190;316;604
00-5-06-01-5258;4;147;174;325;604
00-5-06-01-5259;11;122;188;321;604
00-5-06-01-5260;2;118;178;298;604
00-5-06-01-5261;8;109;174;291;604
00-5-06-01-5262;6;129;180;315;604
00-5-06-01-5263;6;131;192;329;608
00-5-06-01-5264;4;117;70;191;491
00-5-06-01-5265;9;139;115;263;516
00-5-06-01-5266;2;22;31;55;116
00-5-06-01-5267;2;84;102;188;410
00-5-06-01-5268;6;118;178;302;597
00-5-06-01-5269;7;124;159;290;597
00-5-06-01-5270;6;113;149;268;597
00-5-06-01-5271;7;121;180;308;598
00-5-06-01-5272;9;106;193;308;602
00-5-06-01-5273;5;124;180;309;602
00-5-06-01-5274;10;108;205;323;602
00-5-06-01-5275;4;129;183;316;602
00-5-06-01-5276;1;133;163;297;602
00-5-06-01-5277;8;119;185;312;605
00-5-06-01-5278;0;5;6;11;25
00-5-06-01-5279;2;62;108;172;571
00-5-06-01-5280;5;69;118;192;571
00-5-06-01-5281;4;65;108;177;571
00-5-06-01-5282;8;67;111;186;573
00-5-06-02-5283;3;71;93;167;351
00-5-06-02-5284;5;129;132;266;403
00-5-06-03-5285;10;30;44;84;131
00-5-06-03-5286;8;107;105;220;417
00-5-06-03-5287;6;104;112;222;418
00-5-06-03-5288;4;90;67;161;351
00-5-06-03-5289;0;16;40;56;97
00-5-06-04-5290;4;72;102;178;434
00-5-06-04-5291;4;68;120;192;434
00-5-06-04-5292;0;76;111;187;434
00-5-06-05-5293;2;143;98;243;372
00-5-06-05-5294;3;63;22;88;147
00-5-07-01-5295;8;113;210;331;568
00-5-07-01-5296;6;126;215;347;568
00-5-07-01-5297;5;110;191;306;568
00-5-07-01-5298;10;120;172;302;568
00-5-07-01-5299;7;93;208;308;568
00-5-07-01-5300;5;126;188;319;568
00-5-07-01-5301;6;134;177;317;568
00-5-07-01-5302;6;105;202;313;568
00-5-07-01-5303;4;116;229;349;575
00-5-07-01-5304;2;52;39;93;195
00-5-07-01-5305;3;100;92;195;452
00-5-07-01-5306;3;75;64;142;452
00-5-07-01-5307;3;131;153;287;606
00-5-07-01-5308;4;135;135;274;606
00-5-07-01-5309;0;25;63;88;149
00-5-07-01-5310;0;3;19;22;50
00-5-07-01-5311;1;8;6;15;19
00-5-07-02-5312;0;76;110;186;338
00-5-07-02-5313;0;29;30;59;111
00-5-07-02-5314;0;51;67;118;187
00-5-07-02-5315;2;36;76;114;214
00-5-07-02-5316;4;102;124;230;390
00-5-07-02-5317;1;98;110;209;315
00-5-07-02-5318;4;35;77;116;172
00-5-07-03-5319;3;100;157;260;531
00-5-07-03-5320;6;109;102;217;428
00-5-07-03-5321;0;13;12;25;43
00-5-07-03-5322;6;104;178;288;492
00-5-07-04-5323;4;83;129;216;448
00-5-07-04-5324;2;94;134;230;448
00-5-07-04-5325;4;112;125;241;450
00-5-07-04-5326;3;86;120;209;364
00-5-07-04-5327;0;86;142;228;364
00-5-07-04-5328;2;84;86;172;335
00-5-07-04-5329;5;97;71;173;308
00-5-07-04-5330;0;26;14;40;104
00-5-07-04-5331;1;10;47;58;150
00-5-07-04-5332;2;47;64;113;212
00-5-07-04-5333;2;63;122;187;324
00-5-08-01-5334;4;146;196;346;606
00-5-08-01-5335;7;138;179;324;606
00-5-08-01-5336;6;172;209;387;606
00-5-08-01-5337;13;149;203;365;606
00-5-08-01-5338;9;172;181;362;606
00-5-08-01-5339;5;165;196;366;606
00-5-08-01-5340;7;150;196;353;606
00-5-08-01-5341;8;155;222;385;606
00-5-08-01-5342;3;170;165;338;606
00-5-08-01-5343;7;174;193;374;606
00-5-08-01-5344;7;174;196;377;606
00-5-08-01-5345;3;145;218;366;616
00-5-08-01-5346;2;3;30;35;68
00-5-08-01-5347;7;85;96;188;298
00-5-08-02-5348;5;199;183;387;628
00-5-08-02-5349;2;60;48;110;151
00-5-08-02-5350;4;59;93;156;235
00-5-08-03-5351;1;99;157;257;409
00-5-08-03-5352;3;103;148;254;409
00-5-08-03-5353;7;85;141;233;409
00-5-08-03-5354;3;4;8;15;59
00-5-08-03-5355;2;59;31;92;110
00-5-08-04-5356;3;149;124;276;463
00-5-08-04-5357;6;149;134;289;464
00-5-08-04-5358;4;199;95;298;490
00-5-08-04-5359;0;2;4;6;22
00-5-08-05-5360;4;120;83;207;352
00-5-08-05-5361;21;38;41;100;100
00-5-08-05-5362;4;44;101;149;214
00-5-08-06-5363;0;9;35;44;104
00-5-08-06-5364;2;264;113;379;619
00-5-08-06-5365;5;92;103;200;323
00-5-08-07-5366;3;149;148;300;545
00-5-08-07-5367;9;143;169;321;545
00-5-08-07-5368;2;173;161;336;547
00-5-08-07-5369;0;11;27;38;63
00-5-08-08-5370;4;48;115;167;227
00-5-08-08-5371;13;152;188;353;623
00-5-08-08-5372;3;43;65;111;158
00-5-09-01-5373;7;134;172;313;493
00-5-09-01-5374;4;163;152;319;493
00-5-09-01-5375;4;151;161;316;493
00-5-09-01-5376;6;139;152;297;496
00-5-09-01-5377;0;7;2;9;16
00-5-09-02-5378;5;142;183;330;498
00-5-09-02-5379;4;129;160;293;498
00-5-09-02-5380;0;26;34;60;94
00-5-09-02-5381;5;140;86;231;414
00-5-09-03-5382;0;74;65;139;205
00-5-09-03-5383;1;58;57;116;200
00-5-09-03-5384;4;39;28;71;168
00-5-09-03-5385;3;54;43;100;163
00-5-09-03-5386;1;20;52;73;159
00-5-09-04-5387;9;146;152;307;573
00-5-09-04-5388;4;156;151;311;573
00-5-09-04-5389;2;98;105;205;448
00-5-09-05-5390;0;43;24;67;107
00-5-09-05-5391;1;70;30;101;139
00-5-09-05-5392;0;126;116;242;344
00-5-09-05-5393;1;53;32;86;146
00-5-09-06-5394;6;67;70;143;256
00-5-09-06-5395;5;29;79;113;166
00-5-09-06-5396;1;67;68;136;238
00-5-09-06-5397;10;139;153;302;509
00-5-09-06-5398;6;81;47;134;283
00-5-09-06-5399;1;39;22;62;127
00-5-09-06-5400;4;50;30;84;170
00-5-09-06-5401;5;42;55;102;209
00-5-09-06-5402;10;54;46;110;209
00-5-10-01-5403;4;131;101;236;634
00-5-10-01-5404;4;131;134;269;634
00-5-10-01-5405;7;140;115;262;634
00-5-10-01-5406;9;154;115;278;634
00-5-10-01-5407;8;146;118;272;634
00-5-10-01-5408;6;149;126;281;634
00-5-10-01-5409;6;106;137;249;634
00-5-10-01-5410;2;124;135;261;634
00-5-10-01-5411;7;142;136;285;642
00-5-10-01-5412;2;84;71;157;370
00-5-10-01-5413;2;66;77;145;371
00-5-10-01-5414;1;49;48;98;234
00-5-10-01-5415;3;48;22;73;149
00-5-10-01-5416;4;77;103;184;525
00-5-10-01-5417;3;94;121;218;501
00-5-10-01-5418;5;109;94;208;501
00-5-10-02-5419;4;86;110;200;586
00-5-10-02-5420;10;67;99;176;586
00-5-10-02-5421;3;91;111;205;586
00-5-10-02-5422;1;91;111;203;586
00-5-10-02-5423;5;71;148;224;588
00-5-10-02-5424;1;17;27;45;85
00-5-10-02-5425;3;30;45;78;224
00-5-10-02-5426;6;91;90;187;479
00-5-10-02-5427;0;27;33;60;163
00-5-10-02-5428;5;46;45;96;211
00-5-10-03-5429;3;139;112;254;589
00-5-10-03-5430;4;51;39;94;162
00-5-10-03-5431;0;24;11;35;124
00-5-10-04-5432;2;84;122;208;501
00-5-10-04-5433;5;112;112;229;501
00-5-10-04-5434;2;92;101;195;502
00-5-11-01-5435;4;177;206;387;611
00-5-11-01-5436;1;133;221;355;611
00-5-11-01-5437;8;185;179;372;611
00-5-11-01-5438;9;142;238;389;612
00-5-11-01-5439;2;68;76;146;266
00-5-11-01-5440;4;84;76;164;281
00-5-11-01-5441;4;56;39;99;205
00-5-11-02-5442;0;44;32;76;143
00-5-11-02-5443;6;77;96;179;335
00-5-11-02-5444;1;33;25;59;117
00-5-11-03-5445;4;31;37;72;169
00-5-11-03-5446;0;23;18;41;100
00-5-11-03-5447;9;63;65;137;270
00-5-11-03-5448;10;93;115;218;413
00-5-11-03-5449;1;78;99;178;323
00-5-11-04-5450;4;25;65;94;161
00-5-11-04-5451;4;143;76;223;390
00-5-11-05-5452;5;82;82;169;359
00-5-11-05-5453;3;88;86;177;359
00-6-01-01-5454;4;134;212;350;573
00-6-01-01-5455;5;159;186;350;573
00-6-01-01-5456;6;161;178;345;573
00-6-01-01-5457;2;160;173;335;573
00-6-01-01-5458;5;58;5;68;189
00-6-01-01-5459;6;142;208;356;557
00-6-01-01-5460;8;130;178;316;557
00-6-01-01-5461;8;168;173;349;557
00-6-01-01-5462;9;140;180;329;557
00-6-01-01-5463;7;128;194;329;557
00-6-01-01-5464;7;131;161;299;561
00-6-01-01-5465;8;118;157;283;476
00-6-01-01-5466;6;104;161;271;476
00-6-01-01-5467;9;106;150;265;476
00-6-01-01-5468;5;128;153;286;477
00-6-01-02-5469;2;132;84;218;416
00-6-01-02-5470;3;72;82;157;346
00-6-01-02-5471;1;77;84;162;347
00-6-01-02-5472;0;25;27;52;96
00-6-01-02-5473;1;88;47;136;273
00-6-01-03-5474;6;55;134;195;436
00-6-01-03-5475;8;79;77;164;437
00-6-01-03-5476;2;102;47;151;294
00-6-01-03-5477;0;71;85;156;373
00-6-01-03-5478;4;62;82;148;374
00-6-01-03-5479;4;32;73;109;242
00-6-01-03-5480;4;109;104;217;457
00-6-01-03-5481;5;88;103;196;458
00-6-01-03-5482;5;113;87;205;502
00-6-01-03-5483;9;123;80;212;502
00-6-01-04-5484;6;125;109;240;436
00-6-01-04-5485;7;147;121;275;437
00-6-01-04-5486;0;107;89;196;372
00-6-01-04-5487;9;129;145;283;514
00-6-01-04-5488;6;108;148;262;514
00-6-01-04-5489;5;123;118;246;514
00-6-01-04-5490;3;118;94;215;514
00-6-01-04-5491;4;112;120;236;518
00-6-01-04-5492;5;82;80;167;357
00-6-01-04-5493;4;91;89;184;358
00-6-01-04-5494;0;24;22;46;86
00-6-01-04-5495;1;37;24;62;97
00-6-01-04-5496;0;13;8;21;46
00-6-01-04-5497;1;106;80;187;377
00-6-01-04-5498;9;107;90;206;378
00-6-01-04-5499;3;162;116;281;426
00-6-01-04-5500;3;27;18;48;70
00-6-01-04-5501;2;133;80;215;403
00-6-01-04-5502;0;55;9;64;97
00-6-01-04-5503;1;67;40;108;263
00-6-01-04-5504;0;4;16;20;49
00-6-01-04-5505;6;149;118;273;445
00-6-01-04-5506;2;215;30;247;455
00-6-01-04-5507;1;64;35;100;184
00-6-01-04-5508;2;107;77;186;303
00-6-01-04-5509;1;150;23;174;276
00-6-01-04-5510;0;13;4;17;34
00-6-01-05-5511;9;103;101;213;511
00-6-01-05-5512;6;97;97;200;511
00-6-01-05-5513;3;106;97;206;511
00-6-01-05-5514;5;104;94;203;511
00-6-01-05-5515;2;109;99;210;515
00-6-01-05-5516;4;61;25;90;217
00-6-01-05-5517;1;37;22;60;149
00-6-01-05-5518;1;93;77;171;384
00-6-01-05-5519;1;85;68;154;384
00-6-01-05-5520;2;60;68;130;265
00-6-01-05-5521;0;25;4;29;58
00-6-01-05-5522;0;47;39;86;180
00-6-01-05-5523;2;50;15;67;102
00-6-01-05-5524;1;48;48;97;245
00-6-01-05-5525;0;49;36;85;161
00-6-01-05-5526;9;61;72;142;277
00-6-01-05-5527;2;46;24;72;164
00-6-01-06-5528;9;64;123;196;415
00-6-01-06-5529;6;106;102;214;512
00-6-01-06-5530;8;90;116;214;512
00-6-01-06-5531;7;111;113;231;513
00-6-01-06-5532;4;79;59;142;335
00-6-01-06-5533;4;41;90;135;265
00-6-01-07-5534;9;183;148;340;582
00-6-01-07-5535;2;36;50;88;124
00-6-01-08-5536;11;96;171;278;600
00-6-01-08-5537;6;108;136;250;600
00-6-01-08-5538;4;115;153;272;600
00-6-01-08-5539;10;109;165;284;600
00-6-01-08-5540;5;103;163;271;600
00-6-01-08-5541;6;97;148;251;600
00-6-01-08-5542;10;104;142;256;600
00-6-01-08-5543;13;97;150;260;600
00-6-01-08-5544;4;94;163;261;600
00-6-01-08-5545;3;85;166;254;600
00-6-01-08-5546;5;108;159;272;600
00-6-01-08-5547;5;108;163;276;600
00-6-01-08-5548;8;99;141;248;600
00-6-01-08-5549;1;109;157;267;600
00-6-01-08-5550;5;82;153;240;600
00-6-01-08-5551;6;121;128;255;593
00-6-01-08-5552;7;110;169;286;592
00-6-01-08-5553;6;114;184;304;507
00-6-01-08-5554;2;82;110;194;449
00-6-01-08-5555;8;88;133;229;532
00-6-01-08-5556;8;92;135;235;532
00-6-01-08-5557;6;89;149;244;532
00-6-01-08-5558;9;90;156;255;532
00-6-01-08-5559;9;123;199;331;503
00-6-01-08-5560;24;74;126;224;559
00-6-01-08-5561;6;79;165;250;559
00-6-01-08-5562;9;93;165;267;559
00-6-01-08-5563;9;81;156;246;559
00-6-01-08-5564;6;78;169;253;559
00-6-01-08-5565;6;90;137;233;559
00-6-01-08-5566;5;79;136;220;560
00-6-01-08-5567;3;99;147;249;608
00-6-01-08-5568;5;100;131;236;608
00-6-01-08-5569;2;74;149;225;608
00-6-01-08-5570;7;97;129;233;608
00-6-01-08-5571;7;75;144;226;608
00-6-01-08-5572;9;91;151;251;608
00-6-01-08-5573;2;88;165;255;608
00-6-01-08-5574;7;85;146;238;608
00-6-01-08-5575;3;78;158;239;611
00-6-01-08-5576;0;14;1;15;28
00-6-01-09-5577;9;202;196;407;646
00-6-01-09-5578;7;131;157;295;521
00-6-01-09-5579;2;139;171;312;521
00-6-01-09-5580;6;119;162;287;521
00-6-01-09-5581;7;125;161;293;521
00-6-01-09-5582;4;130;167;301;523
00-6-01-09-5583;4;138;78;220;347
00-6-01-10-5584;0;3;1;4;21
00-6-01-11-5585;2;63;88;153;346
00-6-01-11-5586;5;99;115;219;602
00-6-01-11-5587;3;90;117;210;602
00-6-01-11-5588;6;95;136;237;602
00-6-01-11-5589;9;102;150;261;602
00-6-01-11-5590;1;99;132;232;604
00-6-01-11-5591;1;74;78;153;343
00-6-01-11-5592;3;57;61;121;271
00-6-01-11-5593;2;60;81;143;303
00-6-01-11-5594;1;27;6;34;72
00-6-01-11-5595;2;28;29;59;200
00-6-01-11-5596;1;42;29;72;127
00-6-01-11-5597;2;86;79;167;341
00-6-01-11-5598;2;51;57;110;254
00-6-01-11-5599;4;45;64;113;341
00-6-01-11-5600;7;43;63;113;341
00-6-01-12-5601;8;82;183;273;600
00-6-01-12-5602;2;122;172;296;600
00-6-01-12-5603;5;113;162;280;600
00-6-01-12-5604;10;105;168;283;600
00-6-01-12-5605;11;114;152;277;600
00-6-01-12-5606;6;113;150;269;600
00-6-01-12-5607;8;120;177;305;600
00-6-01-12-5608;6;112;156;274;600
00-6-01-12-5609;4;103;175;282;600
00-6-01-12-5610;6;110;160;276;600
00-6-01-12-5611;7;119;144;270;573
00-6-01-12-5612;8;96;156;260;573
00-6-01-12-5613;4;101;129;234;596
00-6-01-12-5614;2;105;124;231;596
00-6-01-12-5615;2;97;143;242;596
00-6-01-12-5616;3;109;110;222;596
00-6-01-12-5617;5;108;108;221;596
00-6-01-12-5618;6;93;129;228;596
00-6-01-12-5619;6;118;124;248;596
00-6-01-12-5620;2;104;125;231;596
00-6-01-12-5621;3;97;103;203;596
00-6-01-12-5622;1;107;142;250;605
00-6-01-13-5623;5;237;53;295;517
00-6-01-13-5624;3;185;38;226;391
00-6-01-13-5625;3;123;80;206;378
00-6-01-14-5626;6;117;141;264;488
00-6-01-14-5627;12;135;102;249;488
00-6-01-14-5628;0;11;11;22;47
00-6-01-15-5629;4;149;210;363;600
00-6-01-15-5630;9;163;176;348;600
00-6-01-15-5631;6;145;196;347;600
00-6-01-15-5632;8;119;243;370;600
00-6-01-15-5633;4;157;202;363;600
00-6-01-15-5634;11;139;205;355;600
00-6-01-15-5635;10;149;202;361;600
00-6-01-15-5636;9;138;207;354;600
00-6-01-15-5637;6;133;212;351;600
00-6-01-15-5638;9;148;182;339;600
00-6-01-15-5639;7;117;209;333;559
00-6-01-15-5640;3;129;191;323;558
00-6-01-15-5641;8;79;46;133;570
00-6-01-15-5642;6;81;144;231;567
00-6-01-15-5643;10;79;143;232;567
00-6-01-15-5644;5;70;141;216;567
00-6-01-15-5645;4;85;130;219;567
00-6-01-15-5646;6;91;132;229;571
00-6-01-15-5647;6;94;161;261;539
00-6-01-15-5648;7;86;152;245;539
00-6-01-15-5649;9;89;130;228;539
00-6-01-15-5650;0;18;14;32;103
00-6-01-16-5651;2;46;52;100;135
00-6-01-16-5652;3;62;42;107;185
00-6-01-16-5653;3;88;41;132;169
00-6-02-01-5654;11;154;195;360;591
00-6-02-01-5655;6;156;183;345;591
00-6-02-01-5656;4;150;178;332;591
00-6-02-01-5657;10;135;191;336;591
00-6-02-01-5658;9;129;192;330;591
00-6-02-01-5659;9;126;203;338;591
00-6-02-01-5660;11;153;200;364;591
00-6-02-01-5661;9;140;203;352;591
00-6-02-01-5662;8;124;196;328;591
00-6-02-01-5663;9;129;175;313;591
00-6-02-01-5664;1;120;218;339;591
00-6-02-01-5665;7;134;213;354;591
00-6-02-01-5666;8;162;170;340;591
00-6-02-01-5667;15;129;195;339;591
00-6-02-01-5668;3;139;216;358;593
00-6-02-01-5669;2;91;143;236;508
00-6-02-01-5670;3;101;142;246;508
00-6-02-01-5671;2;103;137;242;508
00-6-02-01-5672;4;84;147;235;510
00-6-02-01-5673;11;130;213;354;600
00-6-02-01-5674;15;137;218;370;600
00-6-02-01-5675;9;138;209;356;600
00-6-02-01-5676;8;159;185;352;575
00-6-02-01-5677;5;127;229;361;575
00-6-02-02-5678;4;78;137;219;488
00-6-02-02-5679;3;92;120;215;488
00-6-02-02-5680;4;87;134;225;488
00-6-02-02-5681;3;93;107;203;489
00-6-02-02-5682;5;102;194;301;482
00-6-02-02-5683;4;79;187;270;482
00-6-02-02-5684;0;5;2;7;13
00-6-02-03-5685;7;129;210;346;572
00-6-02-03-5686;6;122;161;289;572
00-6-02-03-5687;9;106;208;323;572
00-6-02-03-5688;9;113;184;306;572
00-6-02-03-5689;6;99;186;291;572
00-6-02-03-5690;5;122;184;311;577
00-6-02-03-5691;2;88;66;156;257
00-6-02-04-5692;11;115;152;278;511
00-6-02-04-5693;2;44;44;90;144
00-6-02-04-5694;8;143;174;325;532
00-6-02-05-5695;2;20;63;85;129
00-6-02-05-5696;0;25;12;37;69
00-6-02-05-5698;1;48;44;93;146
00-6-02-06-5699;0;13;27;40;64
00-6-02-06-5700;2;99;158;259;577
00-6-02-06-5701;5;91;153;249;543
00-6-02-06-5702;2;104;151;257;544
00-6-02-06-5703;0;39;53;92;218
00-6-03-01-5704;11;73;250;334;605
00-6-03-01-5705;7;79;228;314;605
00-6-03-01-5706;10;66;237;313;605
00-6-03-01-5707;4;66;277;347;605
00-6-03-01-5708;9;89;234;332;605
00-6-03-01-5709;7;83;222;312;605
00-6-03-01-5710;3;68;257;328;605
00-6-03-01-5711;9;69;259;337;605
00-6-03-01-5712;4;75;217;296;605
00-6-03-01-5713;6;59;239;304;605
00-6-03-01-5714;3;70;237;310;605
00-6-03-01-5715;2;82;247;331;616
00-6-03-01-5716;1;24;104;129;275
00-6-03-01-5717;13;47;154;214;496
00-6-03-01-5718;11;46;180;237;519
00-6-03-01-5719;3;48;175;226;520
00-6-03-01-5720;3;41;40;84;174
00-6-03-01-5721;3;39;139;181;452
00-6-03-01-5722;4;27;117;148;452
00-6-03-01-5723;7;53;151;211;392
00-6-03-01-5724;0;7;12;19;57
00-6-03-01-5725;6;28;80;114;378
00-6-03-01-5726;3;48;61;112;242
00-6-03-01-5727;10;36;163;209;447
00-6-03-01-5728;7;47;141;195;366
00-6-03-01-5729;5;37;152;194;367
00-6-03-01-5730;9;57;185;251;567
00-6-03-01-5731;7;52;239;298;567
00-6-03-01-5732;5;57;220;282;567
00-6-03-01-5733;4;47;213;264;567
00-6-03-01-5734;5;62;176;243;567
00-6-03-01-5735;2;51;193;246;567
00-6-03-01-5736;3;65;229;297;571
00-6-03-01-5737;2;8;33;43;121
00-6-03-02-5738;1;61;140;202;444
00-6-03-02-5739;4;78;130;212;444
00-6-03-02-5740;5;92;138;235;444
00-6-03-02-5741;6;112;209;327;640
00-6-03-02-5742;2;60;125;187;390
00-6-03-02-5743;2;116;149;267;603
00-6-03-03-5744;5;67;190;262;587
00-6-03-03-5745;2;70;185;257;587
00-6-03-03-5746;5;51;126;182;367
00-6-03-03-5747;4;49;120;173;330
00-6-03-03-5748;2;80;116;198;431
00-6-03-03-5749;4;34;129;167;323
00-6-03-03-5750;10;52;112;174;323
00-6-03-03-5751;1;78;94;173;474
00-6-03-03-5752;2;54;92;148;474
00-6-03-03-5753;1;3;28;32;65
00-6-03-03-5754;6;17;111;134;310
00-6-03-03-5755;2;23;105;130;299
00-6-03-04-5756;6;72;232;310;626
00-6-03-04-5757;6;70;231;307;626
00-6-03-04-5758;5;61;119;185;406
00-6-03-04-5759;0;27;65;92;262
00-6-03-04-5760;3;47;35;85;178
00-6-03-05-5761;2;21;49;72;143
00-6-03-05-5762;8;67;209;284;467
00-6-03-05-5763;1;48;136;185;461
00-6-03-05-5764;0;26;60;86;143
00-6-03-06-5765;5;31;151;187;337
00-6-03-06-5766;3;48;101;152;236
00-6-03-06-5767;1;47;124;172;334
00-6-03-07-5768;2;62;108;172;273
00-6-03-07-5769;9;83;127;219;485
00-6-03-07-5770;1;16;28;45;118
00-6-03-07-5771;2;46;82;130;274
00-6-03-07-5772;5;36;77;118;240
00-6-03-07-5773;0;4;13;17;42
00-6-03-07-5774;0;13;15;28;63
00-6-03-07-5775;2;30;40;72;172
00-6-03-08-5776;1;29;77;107;245
00-6-03-08-5777;2;32;54;88;190
00-6-03-08-5778;4;60;168;232;564
00-6-03-08-5779;2;74;89;165;335
00-6-03-08-5780;3;53;98;154;335
00-6-03-09-5781;6;99;142;247;453
00-6-03-09-5782;5;90;113;208;453
00-6-03-09-5783;7;76;174;257;412
00-6-03-09-5784;7;64;157;228;412
00-6-03-09-5785;5;53;160;218;413
00-6-03-09-5786;4;69;98;171;351
00-6-04-01-5787;4;142;163;309;550
00-6-04-01-5788;13;120;179;312;550
00-6-04-01-5789;3;148;169;320;550
00-6-04-01-5790;6;127;148;281;550
00-6-04-01-5791;5;139;144;288;550
00-6-04-01-5792;4;120;172;296;550
00-6-04-01-5793;9;127;193;329;550
00-6-04-01-5794;9;123;160;292;550
00-6-04-01-5795;2;106;194;302;550
00-6-04-01-5796;2;80;53;135;215
00-6-04-01-5797;1;23;13;37;74
00-6-04-01-5798;2;34;47;83;148
00-6-04-01-5799;0;14;15;29;50
00-6-04-01-5800;9;111;179;299;537
00-6-04-01-5801;11;111;159;281;537
00-6-04-01-5802;7;108;179;294;537
00-6-04-02-5803;1;64;63;128;211
00-6-04-02-5804;1;51;102;154;266
00-6-04-02-5805;5;169;52;226;360
00-6-04-02-5806;4;21;73;98;174
00-6-04-03-5807;0;13;12;25;54
00-6-04-03-5808;5;98;137;240;448
00-6-04-03-5809;10;113;121;244;448
00-6-04-03-5810;7;115;127;249;450
00-6-04-03-5811;3;86;127;216;459
00-6-04-03-5812;4;76;138;218;459
00-6-04-03-5813;2;108;121;231;461
00-6-05-01-5814;3;93;144;240;548
00-6-05-01-5815;3;100;158;261;548
00-6-05-01-5816;7;106;148;261;548
00-6-05-01-5817;9;118;150;277;548
00-6-05-01-5818;4;106;151;261;548
00-6-05-01-5819;4;133;149;286;551
00-6-05-01-5820;2;50;171;223;420
00-6-05-01-5821;2;47;157;206;420
00-6-05-01-5822;2;67;183;252;550
00-6-05-01-5823;4;87;86;177;351
00-6-05-01-5824;9;84;152;245;509
00-6-05-01-5825;7;114;137;258;509
00-6-05-01-5826;6;110;142;258;511
00-6-05-01-5827;0;42;15;57;108
00-6-05-02-5828;7;70;199;276;543
00-6-05-02-5829;5;84;202;291;543
00-6-05-02-5830;4;64;204;272;543
00-6-05-02-5831;6;73;201;280;543
00-6-05-02-5832;9;70;198;277;543
00-6-05-02-5833;5;81;177;263;543
00-6-05-02-5834;8;86;168;262;552
00-6-05-02-5835;8;84;187;279;552
00-6-05-02-5836;4;78;163;245;554
00-6-05-02-5837;7;86;123;216;376
00-6-05-02-5838;4;38;99;141;366
00-6-05-02-5839;2;41;111;154;366
00-6-05-02-5840;2;88;186;276;582
00-6-05-02-5841;5;73;181;259;583
00-6-05-02-5842;1;29;117;147;413
00-6-05-02-5843;2;25;79;106;229
00-6-05-02-5844;3;19;17;39;120
00-6-05-02-5845;0;15;21;36;45
00-6-05-03-5846;5;44;114;163;472
00-6-05-03-5847;3;46;123;172;472
00-6-05-03-5848;1;15;15;31;101
00-6-05-03-5849;1;14;23;38;71
00-6-05-03-5850;1;43;49;93;255
00-6-05-03-5851;2;26;24;52;126
00-6-05-03-5852;0;6;30;36;86
00-6-05-03-5853;1;26;36;63;135
00-6-05-03-5854;1;18;47;66;123
00-6-05-04-5855;1;46;105;152;366
00-6-05-04-5856;5;61;120;186;367
00-6-05-04-5857;6;62;179;247;530
00-6-05-04-5858;8;70;166;244;530
00-6-05-04-5859;8;82;150;240;530
00-6-05-04-5860;5;64;148;217;530
00-6-05-04-5861;16;88;170;274;534
00-6-05-05-5862;5;121;123;249;626
00-6-05-05-5863;5;101;147;253;627
00-6-05-05-5864;7;66;95;168;328
00-6-05-05-5865;4;58;88;150;316
00-6-05-05-5866;5;69;199;273;628
00-6-05-05-5867;2;49;178;229;629
00-6-05-05-5868;0;33;22;55;93
00-6-05-06-5869;6;30;96;132;328
00-6-05-06-5870;0;21;118;139;328
00-6-05-06-5871;2;17;27;46;98
00-6-05-06-5872;4;24;49;77;123
00-6-05-06-5873;2;17;100;119;261
00-6-05-06-5874;0;14;54;68;120
00-6-06-01-5875;2;99;194;295;629
00-6-06-01-5876;1;98;241;340;629
00-6-06-01-5877;6;86;228;320;629
00-6-06-01-5878;7;80;210;297;629
00-6-06-01-5879;4;101;209;314;629
00-6-06-01-5880;7;99;210;316;629
00-6-06-01-5881;8;95;206;309;632
00-6-06-01-5882;1;35;107;143;332
00-6-06-01-5883;7;89;198;294;646
00-6-06-01-5884;11;57;137;205;512
00-6-06-01-5885;5;70;133;208;512
00-6-06-01-5886;7;48;123;178;598
00-6-06-01-5887;2;18;27;47;144
00-6-06-01-5888;0;75;210;285;577
00-6-06-01-5889;2;63;203;268;578
00-6-06-01-5890;4;58;210;272;595
00-6-06-01-5891;1;60;150;211;595
00-6-06-01-5892;5;68;183;256;595
00-6-06-01-5893;5;67;171;243;595
00-6-06-01-5894;9;62;179;250;595
00-6-06-01-5895;11;60;171;242;595
00-6-06-01-5896;4;58;183;245;601
00-6-06-01-5897;2;53;148;203;449
00-6-06-01-5898;7;45;137;189;449
00-6-06-01-5899;8;44;145;197;450
00-6-06-01-5900;2;82;190;274;611
00-6-06-01-5901;3;81;183;267;611
00-6-06-01-5902;2;56;123;181;601
00-6-06-02-5903;2;17;42;61;163
00-6-06-02-5904;5;69;86;160;335
00-6-06-02-5905;6;58;87;151;336
00-6-06-02-5906;1;139;166;306;533
00-6-06-02-5907;0;17;48;65;83
00-6-06-02-5908;1;13;33;47;86
00-6-06-02-5909;1;10;13;24;69
00-6-06-02-5910;5;119;146;270;467
00-6-06-02-5911;0;33;32;65;142
00-6-06-02-5912;0;65;137;202;385
00-6-06-03-5913;5;96;231;332;562
00-6-06-03-5914;3;92;198;293;563
00-6-06-03-5915;9;121;217;347;611
00-6-06-03-5917;2;48;141;191;428
00-6-06-03-5918;3;32;46;81;312
00-6-06-03-5919;3;5;2;10;24
00-6-07-01-5920;3;128;160;291;650
00-6-07-01-5921;1;115;167;283;650
00-6-07-01-5922;7;112;162;281;650
00-6-07-01-5924;7;113;157;277;642
00-6-07-01-5925;6;133;167;306;641
00-6-07-01-5926;0;11;22;33;131
00-6-07-01-5927;9;80;124;213;539
00-6-07-01-5928;6;68;163;237;539
00-6-07-01-5929;8;89;124;221;539
00-6-07-01-5930;3;72;123;198;539
00-6-07-01-5931;4;78;122;204;541
00-6-07-01-5932;3;75;85;163;426
00-6-07-01-5933;0;12;16;28;141
00-6-07-01-5934;5;129;165;299;632
00-6-07-01-5935;3;108;174;285;632
00-6-07-01-5936;3;117;112;232;518
00-6-07-01-5937;1;6;4;11;33
00-6-07-02-5938;2;89;178;269;646
00-6-07-02-5939;6;73;208;287;646
00-6-07-02-5940;7;76;214;297;646
00-6-07-02-5941;8;92;198;298;649
00-6-07-02-5942;5;55;152;212;535
00-6-07-02-5943;3;61;153;217;535
00-6-07-02-5944;3;54;142;199;535
00-6-07-02-5945;7;69;134;210;536
00-6-07-02-5946;3;52;152;207;622
00-6-07-02-5947;9;52;161;222;623
00-6-07-02-5948;2;45;135;182;427
00-6-07-02-5949;7;46;148;201;427
00-6-07-02-5950;0;9;9;18;84
00-6-07-03-5951;3;90;150;243;599
00-6-07-03-5952;3;102;146;251;600
00-6-07-03-5953;9;115;151;275;593
00-6-07-03-5954;3;122;149;274;593
00-6-07-03-5955;8;96;154;258;593
00-6-07-03-5956;9;105;143;257;593
00-6-07-03-5957;4;93;180;277;593
00-6-07-03-5958;7;118;156;281;593
00-6-07-03-5959;7;111;152;270;593
00-6-07-03-5960;4;97;153;254;593
00-6-07-03-5961;2;115;169;286;593
00-6-07-03-5962;8;107;175;290;593
00-6-07-03-5963;9;108;163;280;597
00-6-07-03-5964;0;18;20;38;92
00-6-07-03-5965;0;11;21;32;61
00-6-07-03-5966;0;29;17;46;65
00-6-07-03-5967;1;28;24;53;139
00-6-07-03-5968;4;93;90;187;424
00-6-07-03-5969;4;77;101;182;424
00-6-07-03-5970;0;59;34;93;172
00-6-07-03-5971;6;138;152;296;555
00-6-07-03-5972;12;107;170;289;555
00-6-07-03-5973;0;58;106;164;581
00-6-07-04-5974;5;55;117;177;460
00-6-07-04-5975;3;54;128;185;461
00-6-07-04-5976;2;28;84;114;260
00-6-07-04-5977;3;20;23;46;86
00-6-07-04-5978;3;46;131;180;437
00-6-07-04-5979;0;34;103;137;278
00-6-07-04-5981;0;27;30;57;226
00-6-07-04-5982;4;31;91;126;260
00-6-07-04-5983;4;83;80;167;361
00-6-07-04-5984;6;50;80;136;271
00-6-07-04-5985;1;107;92;200;387
00-6-07-04-5986;14;103;101;218;449
00-6-07-04-5987;3;80;101;184;393
00-6-08-01-5988;7;121;142;270;546
00-6-08-01-5989;5;111;145;261;546
00-6-08-01-5990;3;105;154;262;546
00-6-08-01-5991;7;126;158;291;546
00-6-08-01-5992;6;137;165;308;546
00-6-08-01-5993;4;116;152;272;551
00-6-08-01-5994;3;107;162;272;616
00-6-08-01-5995;0;95;138;233;519
00-6-08-01-5996;7;104;153;264;519
00-6-08-01-5997;3;62;130;195;398
00-6-08-01-5998;10;139;225;374;623
00-6-08-01-5999;2;131;162;295;464
00-6-08-01-6000;4;105;135;244;482
00-6-08-01-6001;4;100;165;269;483
00-6-08-01-6002;5;61;45;111;183
00-6-08-01-6003;7;103;155;265;518
00-6-08-01-6004;8;120;132;260;518
00-6-08-01-6005;3;109;188;300;520
00-6-08-01-6006;0;9;8;17;23
00-6-08-01-6007;8;100;182;290;649
00-6-08-02-6008;3;132;147;282;650
00-6-08-02-6009;5;111;178;294;650
00-6-08-02-6010;4;103;174;281;650
00-6-08-02-6011;7;120;139;266;650
00-6-08-02-6012;7;91;175;273;647
00-6-08-02-6013;6;85;146;237;647
00-6-08-02-6014;6;104;112;222;614
00-6-08-02-6015;7;98;120;225;614
00-6-08-02-6016;18;141;107;266;576
00-6-08-02-6017;5;123;107;235;423
00-6-08-02-6018;5;88;115;208;424
00-6-08-02-6019;0;31;55;86;182
00-6-08-02-6020;4;93;134;231;482
00-6-08-02-6021;5;74;166;245;483
00-6-08-02-6022;3;28;36;67;176
00-6-08-02-6023;6;61;98;165;344
00-6-08-02-6024;2;73;92;167;344
00-6-08-03-6025;4;97;173;274;523
00-6-08-03-6026;3;87;174;264;523
00-6-08-03-6028;4;93;177;274;523
00-6-08-03-6029;7;103;181;291;527
00-6-08-03-6030;8;66;86;160;367
00-6-08-03-6031;4;68;73;145;367
00-6-08-03-6032;4;44;116;164;286
00-6-08-03-6033;3;89;107;199;410
00-6-08-03-6034;2;85;119;206;411
00-6-08-03-6035;2;27;67;96;192
00-6-08-03-6036;1;42;53;96;240
00-6-08-03-6037;6;141;172;319;567
00-6-08-04-6038;3;37;66;106;195
00-6-08-04-6039;6;80;132;218;399
00-6-08-04-6040;8;66;121;195;383
00-6-08-04-6041;6;89;232;327;589
00-6-08-04-6042;0;44;19;63;93
00-6-08-04-6043;3;27;37;67;122
00-6-08-04-6044;1;59;101;161;335
00-6-08-04-6045;7;91;179;277;635
00-6-08-04-6046;5;72;184;261;635
00-6-08-05-6047;3;14;30;47;82
00-6-08-05-6048;3;110;117;230;402
00-6-08-05-6049;5;96;164;265;495
00-6-08-05-6050;3;71;71;145;256
00-6-08-05-6051;0;42;69;111;225
00-6-08-05-6052;4;48;147;199;381
00-6-08-06-6053;3;82;111;196;364
00-6-08-06-6054;2;73;126;201;364
00-6-08-06-6055;3;124;173;300;541
00-6-08-06-6056;11;42;98;151;299
00-6-08-06-6057;5;96;92;193;491
00-6-08-06-6058;8;81;134;223;443
00-6-08-06-6059;8;90;135;233;444
00-6-08-06-6060;2;87;108;197;427
00-6-09-01-6061;4;104;139;247;505
00-6-09-01-6062;1;121;143;265;505
00-6-09-01-6063;2;118;114;234;507
00-6-09-01-6064;2;65;126;193;454
00-6-09-01-6065;0;48;31;79;159
00-6-09-01-6066;4;27;44;75;179
00-6-09-01-6067;9;93;141;243;601
00-6-09-01-6068;4;98;151;253;601
00-6-09-01-6069;5;109;170;284;601
00-6-09-01-6070;8;84;164;256;602
00-6-09-01-6071;3;111;141;255;448
00-6-09-01-6072;4;119;137;260;448
00-6-09-01-6073;5;98;124;227;642
00-6-09-01-6074;6;97;125;228;642
00-6-09-01-6075;0;22;29;51;94
00-6-09-01-6076;2;45;35;82;184
00-6-09-01-6077;5;46;37;88;184
00-6-09-01-6078;1;36;46;83;279
00-6-09-01-6079;1;41;58;100;190
00-6-09-01-6080;0;14;52;66;146
00-6-09-01-6081;4;81;104;189;418
00-6-09-01-6082;4;74;166;244;479
00-6-09-01-6083;9;43;92;144;326
00-6-09-01-6084;5;33;82;120;327
00-6-09-01-6085;0;9;8;17;37
00-6-09-01-6086;0;47;5;52;90
00-6-09-01-6087;0;38;11;49;76
00-6-09-01-6088;1;78;28;107;239
00-6-09-01-6089;2;40;60;102;274
00-6-09-01-6090;5;115;120;240;476
00-6-09-01-6091;4;100;157;261;476
00-6-09-01-6092;5;87;130;222;476
00-6-09-01-6093;8;118;136;262;476
00-6-09-01-6094;6;84;92;182;404
00-6-09-01-6095;1;86;56;143;320
00-6-09-01-6096;5;43;58;106;207
00-6-09-01-6097;3;18;18;39;111
00-6-10-01-6098;4;88;138;230;559
00-6-10-01-6099;5;107;156;268;559
00-6-10-01-6100;10;102;154;266;559
00-6-10-01-6101;8;100;148;256;559
00-6-10-01-6102;2;110;157;269;559
00-6-10-01-6103;6;120;146;272;559
00-6-10-01-6104;9;106;163;278;559
00-6-10-01-6105;7;124;136;267;559
00-6-10-01-6106;9;96;151;256;559
00-6-10-01-6107;8;110;151;269;559
00-6-10-01-6108;7;97;140;244;559
00-6-10-01-6109;6;121;142;269;567
00-6-10-01-6110;2;43;41;86;158
00-6-10-01-6111;7;49;88;144;273
00-6-10-01-6112;2;70;90;162;355
00-6-10-01-6113;7;74;91;172;418
00-6-10-01-6114;2;51;92;145;418
00-6-10-01-6115;3;60;109;172;418
00-6-10-01-6116;2;94;73;169;322
00-6-10-01-6117;1;84;73;158;323
00-6-10-01-6118;4;95;115;214;448
00-6-10-01-6119;0;50;32;82;178
00-6-10-01-6120;10;107;179;296;572
00-6-10-01-6121;6;116;171;293;572
00-6-10-01-6122;1;110;153;264;573
00-6-10-01-6123;3;37;43;83;175
00-6-10-01-6124;5;77;138;220;469
00-6-10-01-6126;1;99;47;147;332
00-6-10-01-6127;7;64;137;208;497
00-6-10-01-6128;3;77;135;215;497
00-6-10-01-6129;9;71;153;233;497
00-6-10-01-6130;6;88;141;235;498
00-6-10-01-6131;2;18;4;24;33
00-6-10-02-6132;3;88;128;219;614
00-6-10-02-6133;10;75;143;228;614
00-6-10-02-6134;7;87;166;260;614
00-6-10-02-6135;8;86;127;221;614
00-6-10-02-6136;5;92;157;254;614
00-6-10-02-6137;4;76;126;206;615
00-6-10-03-6138;4;93;132;229;610
00-6-10-03-6139;5;87;130;222;610
00-6-10-03-6140;3;79;106;188;610
00-6-10-03-6141;9;69;139;217;610
00-6-10-03-6142;8;88;132;228;610
00-6-10-03-6143;4;67;140;211;491
00-6-10-03-6144;1;87;116;204;491
00-6-10-03-6145;9;77;138;224;518
00-6-10-03-6146;7;73;94;174;329
00-6-10-03-6147;5;97;124;226;556
00-6-10-03-6148;3;92;142;237;569
00-6-10-03-6149;5;92;153;250;569
00-6-10-03-6150;1;107;141;249;571
00-6-10-03-6151;7;85;116;208;566
00-6-10-03-6152;2;54;138;194;566
00-6-10-03-6153;8;77;96;181;566
00-6-10-03-6154;3;46;117;166;566
00-6-10-03-6155;3;56;94;153;570
00-6-10-04-6156;10;87;183;280;648
00-6-10-04-6157;11;104;173;288;648
00-6-10-04-6158;13;107;150;270;648
00-6-10-04-6159;11;104;162;277;648
00-6-10-04-6160;9;103;161;273;634
00-6-10-04-6161;6;105;167;278;635
00-6-10-04-6162;4;79;141;224;436
00-6-10-04-6163;9;58;66;133;257
00-6-10-04-6164;10;72;117;199;416
00-6-10-04-6165;1;38;130;169;392
00-6-10-04-6167;5;103;151;259;601
00-6-10-04-6168;5;150;134;289;601
00-6-10-04-6169;9;99;163;271;603
00-6-11-01-6170;3;124;128;255;581
00-6-11-01-6172;6;107;140;253;581
00-6-11-01-6173;4;94;156;254;581
00-6-11-01-6174;2;104;151;257;581
00-6-11-01-6175;3;111;164;278;581
00-6-11-01-6177;10;124;144;278;586
00-6-11-01-6178;1;87;154;242;543
00-6-11-01-6179;1;83;133;217;543
00-6-11-01-6180;2;76;148;226;543
00-6-11-01-6181;2;91;152;245;543
00-6-11-01-6182;11;100;154;265;543
00-6-11-01-6183;3;70;155;228;547
00-6-11-01-6184;1;26;68;95;221
00-6-11-01-6185;3;57;41;101;258
00-6-11-01-6186;3;132;117;252;569
00-6-11-02-6187;5;78;150;233;606
00-6-11-02-6188;1;98;151;250;606
00-6-11-02-6189;2;119;174;295;524
00-6-11-02-6190;4;86;173;263;524
00-6-11-02-6191;5;98;181;284;524
00-6-11-02-6192;3;109;172;284;524
00-6-11-02-6193;4;108;141;253;625
00-6-11-02-6194;0;136;129;265;625
00-7-01-01-6195;18;150;184;352;632
00-7-01-01-6196;10;142;139;291;632
00-7-01-01-6197;11;134;162;307;632
00-7-01-01-6198;8;147;147;302;632
00-7-01-01-6199;10;121;149;280;632
00-7-01-01-6200;6;116;146;268;632
00-7-01-01-6201;9;124;164;297;632
00-7-01-01-6202;11;131;163;305;632
00-7-01-01-6203;13;134;171;318;632
00-7-01-01-6204;11;122;154;287;633
00-7-01-01-6205;12;82;171;265;625
00-7-01-01-6206;4;74;183;261;625
00-7-01-01-6207;2;77;171;250;625
00-7-01-01-6208;8;64;158;230;625
00-7-01-01-6209;7;68;177;252;625
00-7-01-01-6210;5;92;175;272;625
00-7-01-01-6211;6;87;176;269;631
00-7-01-01-6212;10;85;141;236;605
00-7-01-01-6213;15;77;198;290;585
00-7-01-01-6214;7;88;186;281;585
00-7-01-01-6215;7;82;185;274;585
00-7-01-01-6216;8;91;164;263;585
00-7-01-01-6217;7;93;175;275;585
00-7-01-01-6218;6;83;181;270;585
00-7-01-01-6219;8;113;172;293;585
00-7-01-01-6220;8;83;177;268;592
00-7-01-01-6221;13;124;185;322;566
00-7-01-01-6222;10;121;132;263;566
00-7-01-01-6223;10;128;158;296;566
00-7-01-01-6224;10;116;170;296;566
00-7-01-01-6225;13;127;139;279;566
00-7-01-01-6226;5;107;151;263;566
00-7-01-01-6227;11;102;176;289;566
00-7-01-01-6228;8;122;157;287;566
00-7-01-01-6229;10;112;153;275;566
00-7-01-01-6230;9;154;162;325;571
00-7-01-01-6231;7;97;165;269;627
00-7-01-01-6232;2;61;200;263;627
00-7-01-01-6233;8;59;181;248;627
00-7-01-01-6234;3;54;182;239;627
00-7-01-01-6235;19;64;143;226;627
00-7-01-01-6236;8;68;173;249;627
00-7-01-01-6237;4;59;180;243;627
00-7-01-01-6238;6;77;194;277;627
00-7-01-01-6239;5;72;176;253;632
00-7-01-01-6240;4;37;90;131;270
00-7-01-01-6241;10;78;166;254;507
00-7-01-01-6242;7;85;177;269;507
00-7-01-01-6243;10;87;153;250;507
00-7-01-01-6244;12;88;164;264;507
00-7-01-01-6245;9;101;138;248;509
00-7-01-01-6246;7;51;140;198;530
00-7-01-01-6247;3;60;152;215;530
00-7-01-01-6248;7;56;153;216;530
00-7-01-01-6249;4;60;165;229;530
00-7-01-01-6250;5;70;166;241;533
00-7-01-01-6251;7;63;186;256;629
00-7-01-01-6252;8;90;161;259;629
00-7-01-01-6253;9;85;178;272;629
00-7-01-01-6254;4;70;184;258;629
00-7-01-01-6255;9;73;203;285;629
00-7-01-01-6256;11;78;189;278;629
00-7-01-01-6257;12;72;184;268;629
00-7-01-01-6258;7;91;192;290;629
00-7-01-01-6259;1;67;206;274;629
00-7-01-01-6260;8;69;186;263;629
00-7-01-01-6261;10;70;205;285;638
00-7-01-01-6262;7;124;177;308;605
00-7-01-01-6263;18;108;175;301;605
00-7-01-01-6264;10;121;161;292;605
00-7-01-01-6265;5;115;189;309;605
00-7-01-01-6266;16;97;181;294;606
00-7-01-01-6267;3;47;96;146;321
00-7-01-01-6268;0;3;3;6;18
00-7-01-01-6269;9;97;162;268;615
00-7-01-01-6270;15;98;155;268;615
00-7-01-01-6271;11;89;185;285;615
00-7-01-01-6272;13;87;169;269;615
00-7-01-01-6273;12;94;179;285;615
00-7-01-01-6274;32;77;154;263;615
00-7-01-01-6275;9;92;162;263;615
00-7-01-01-6277;10;77;176;263;617
00-7-01-01-6278;7;110;137;254;590
00-7-01-02-6279;9;87;100;196;356
00-7-01-02-6280;3;86;96;185;357
00-7-01-02-6281;5;89;120;214;525
00-7-01-02-6282;2;95;130;227;526
00-7-01-02-6283;12;48;88;148;457
00-7-01-02-6284;12;85;113;210;625
00-7-01-02-6285;9;75;126;210;625
00-7-01-02-6286;8;67;131;206;625
00-7-01-02-6287;2;83;63;148;236
00-7-01-02-6288;2;95;56;153;421
00-7-01-02-6289;7;132;59;198;422
00-7-01-02-6290;8;51;87;146;376
00-7-01-02-6291;9;61;91;161;376
00-7-01-02-6292;7;81;111;199;387
00-7-01-02-6293;8;91;176;275;625
00-7-01-02-6294;11;97;143;251;490
00-7-01-02-6295;10;83;129;222;490
00-7-01-02-6296;7;83;148;238;491
00-7-01-02-6297;9;86;91;186;509
00-7-01-02-6298;7;91;80;178;620
00-7-01-02-6299;1;16;73;90;260
00-7-01-02-6300;5;83;71;159;344
00-7-01-02-6301;3;38;93;134;345
00-7-01-02-6302;25;180;67;272;472
00-7-01-02-6303;5;18;118;141;469
00-7-01-02-6304;7;39;90;136;470
00-7-01-02-6305;2;4;16;22;67
00-7-01-03-6306;8;75;135;218;561
00-7-01-03-6307;9;61;155;225;561
00-7-01-03-6308;4;61;150;215;561
00-7-01-03-6309;3;66;142;211;561
00-7-01-03-6310;13;56;154;223;561
00-7-01-03-6311;7;58;169;234;562
00-7-01-03-6312;4;85;143;232;480
00-7-01-03-6313;3;91;148;242;481
00-7-01-03-6314;2;50;38;90;176
00-7-01-03-6315;2;63;110;175;393
00-7-01-03-6316;6;45;121;172;393
00-7-01-03-6317;3;55;57;115;217
00-7-01-03-6318;5;60;43;108;421
00-7-01-03-6319;1;13;13;27;53
00-7-01-04-6320;6;108;143;257;529
00-7-01-04-6321;1;114;161;276;529
00-7-01-04-6322;1;39;97;137;269
00-7-01-04-6323;9;114;87;210;591
00-7-01-04-6324;6;96;109;211;592
00-7-01-04-6325;3;68;116;187;486
00-7-01-04-6326;9;68;128;205;486
00-7-01-04-6327;8;71;119;198;486
00-7-01-04-6328;8;59;115;182;345
00-7-01-04-6329;1;26;105;132;287
00-7-01-04-6330;2;54;160;216;458
00-7-01-04-6331;6;51;134;191;458
00-7-01-04-6332;3;47;140;190;459
00-7-02-01-6334;6;157;203;366;602
00-7-02-01-6335;7;113;226;346;602
00-7-02-01-6336;9;148;193;350;602
00-7-02-01-6337;10;134;224;368;602
00-7-02-01-6338;4;123;207;334;602
00-7-02-01-6339;12;145;201;358;602
00-7-02-01-6340;9;142;212;363;602
00-7-02-01-6341;9;125;203;337;602
00-7-02-01-6342;9;126;204;339;602
00-7-02-01-6343;8;145;209;362;602
00-7-02-01-6344;7;132;196;335;602
00-7-02-01-6345;7;146;193;346;602
00-7-02-01-6346;6;129;218;353;602
00-7-02-01-6347;8;130;219;357;602
00-7-02-01-6348;15;133;206;354;602
00-7-02-01-6349;11;126;198;335;602
00-7-02-01-6350;8;144;208;360;602
00-7-02-01-6351;6;127;221;354;602
00-7-02-01-6352;6;129;226;361;602
00-7-02-01-6353;6;141;183;330;602
00-7-02-01-6354;3;147;200;350;602
00-7-02-01-6355;10;143;228;381;602
00-7-02-01-6356;1;132;202;335;624
00-7-02-01-6357;9;77;111;197;336
00-7-02-01-6358;5;69;100;174;336
00-7-02-01-6359;8;126;212;346;567
00-7-02-01-6360;3;130;205;338;567
00-7-02-01-6361;4;138;198;340;567
00-7-02-01-6362;6;146;195;347;567
00-7-02-01-6363;10;117;206;333;567
00-7-02-01-6364;7;131;229;367;572
00-7-02-01-6365;1;93;121;215;440
00-7-02-01-6366;4;110;130;244;441
00-7-02-01-6367;1;95;111;207;400
00-7-02-01-6368;2;68;124;194;400
00-7-02-01-6369;2;9;13;24;28
00-7-02-01-6370;5;107;203;315;566
00-7-02-01-6371;7;98;193;298;566
00-7-02-01-6372;6;96;184;286;566
00-7-02-01-6373;8;109;180;297;566
00-7-02-01-6374;6;74;210;290;566
00-7-02-01-6375;8;103;196;307;566
00-7-02-01-6376;3;105;203;311;566
00-7-02-01-6377;7;97;185;289;572
00-7-02-02-6378;2;106;190;298;527
00-7-02-02-6379;5;110;189;304;527
00-7-02-02-6380;8;90;185;283;527
00-7-02-02-6381;13;88;184;285;527
00-7-02-02-6382;2;133;184;319;527
00-7-02-02-6383;4;109;184;297;527
00-7-02-02-6384;13;108;185;306;527
00-7-02-02-6385;6;107;187;300;533
00-7-02-02-6386;8;130;194;332;578
00-7-02-02-6387;6;107;197;310;578
00-7-02-02-6388;8;107;208;323;517
00-7-02-02-6389;13;125;177;315;517
00-7-02-02-6390;9;120;189;318;518
00-7-02-02-6391;6;96;124;226;329
00-7-02-02-6392;1;94;131;226;330
00-7-02-02-6393;11;87;129;227;469
00-7-02-02-6394;5;85;138;228;469
00-7-02-02-6395;11;75;137;223;470
00-7-02-03-6396;3;96;157;256;505
00-7-02-03-6397;4;90;155;249;505
00-7-02-03-6398;9;112;143;264;506
00-7-02-03-6399;10;102;212;324;574
00-7-02-03-6400;7;101;217;325;574
00-7-02-03-6401;7;105;193;305;574
00-7-02-03-6402;8;99;219;326;574
00-7-02-03-6404;8;100;201;309;574
00-7-02-03-6405;8;103;215;326;574
00-7-02-03-6406;9;100;230;339;574
00-7-02-03-6407;2;95;210;307;574
00-7-02-03-6408;3;103;202;308;582
00-7-02-03-6409;3;78;161;242;591
00-7-02-03-6410;7;91;161;259;591
00-7-02-03-6411;6;83;162;251;592
00-7-02-03-6412;6;95;216;317;558
00-7-02-03-6413;11;111;204;326;558
00-7-02-03-6414;4;75;167;246;531
00-7-02-03-6415;10;84;159;253;531
00-7-02-03-6416;7;84;123;214;531
00-7-02-03-6417;4;95;134;233;463
00-7-02-03-6418;2;92;135;229;463
00-7-02-03-6419;2;98;146;246;463
00-7-02-03-6420;7;68;148;223;477
00-7-02-03-6421;0;67;182;249;477
00-7-02-03-6422;5;99;163;267;456
00-7-02-03-6423;6;102;171;279;585
00-7-02-03-6424;3;71;117;191;323
00-7-02-03-6425;6;57;163;226;546
00-7-02-03-6426;4;61;133;198;546
00-7-02-03-6427;5;75;169;249;548
00-7-02-03-6428;1;43;42;86;148
00-7-02-03-6429;2;28;95;125;242
00-7-02-03-6430;5;58;123;186;375
00-7-02-03-6431;4;50;149;203;375
00-7-02-04-6432;0;74;49;123;275
00-7-02-04-6433;2;74;184;260;544
00-7-02-04-6434;4;78;168;250;544
00-7-02-04-6435;4;72;156;232;544
00-7-02-04-6436;5;88;169;262;544
00-7-02-04-6437;6;80;178;264;544
00-7-02-04-6438;2;78;169;249;544
00-7-02-04-6439;5;72;191;268;544
00-7-02-04-6440;2;90;180;272;549
00-7-02-04-6441;0;79;97;176;466
00-7-02-04-6442;3;71;115;189;466
00-7-02-04-6443;3;65;173;241;481
00-7-02-04-6444;5;111;187;303;540
00-7-02-04-6445;6;75;173;254;540
00-7-02-04-6446;7;77;198;282;540
00-7-02-04-6447;6;96;164;266;540
00-7-02-04-6448;4;85;171;260;542
00-7-02-04-6449;0;37;18;55;372
00-7-02-04-6450;0;20;50;70;172
00-7-02-04-6451;5;80;162;247;555
00-7-02-04-6452;9;73;144;226;555
00-7-02-04-6453;8;85;162;255;557
00-7-02-04-6454;2;35;11;48;246
00-7-02-04-6455;0;21;4;25;112
00-7-02-04-6456;1;61;28;90;210
00-7-02-05-6457;0;98;210;308;587
00-7-02-05-6458;5;80;188;273;587
00-7-02-05-6459;7;89;167;263;587
00-7-02-05-6460;7;99;198;304;587
00-7-02-05-6461;3;97;199;299;587
00-7-02-05-6462;4;91;203;298;587
00-7-02-05-6463;7;81;196;284;587
00-7-02-05-6464;6;92;190;288;587
00-7-02-05-6465;5;67;195;267;587
00-7-02-05-6466;8;68;188;264;587
00-7-02-05-6467;4;82;207;293;587
00-7-02-05-6468;3;84;184;271;587
00-7-02-05-6469;10;82;191;283;587
00-7-02-05-6470;7;89;180;276;587
00-7-02-05-6471;5;83;213;301;598
00-7-02-05-6472;4;64;169;237;542
00-7-02-05-6473;5;75;151;231;542
00-7-02-05-6474;2;69;179;250;542
00-7-02-05-6475;6;87;199;292;600
00-7-02-05-6476;14;106;197;317;600
00-7-02-05-6477;9;99;198;306;600
00-7-02-05-6478;7;85;180;272;600
00-7-02-05-6479;3;86;190;279;584
00-7-02-05-6480;5;98;209;312;583
00-7-02-05-6481;4;91;192;287;531
00-7-02-05-6482;5;84;194;283;531
00-7-02-05-6483;6;107;178;291;532
00-7-02-05-6484;6;77;199;282;489
00-7-02-05-6485;15;82;137;234;489
00-7-02-05-6486;1;94;202;297;593
00-7-02-05-6487;10;107;186;303;593
00-7-02-05-6488;4;101;186;291;594
00-7-02-05-6489;3;69;132;204;374
00-7-02-05-6490;8;85;186;279;600
00-7-02-05-6491;12;88;211;311;600
00-7-02-05-6492;6;85;198;289;600
00-7-02-05-6493;7;92;175;274;600
00-7-02-05-6494;5;77;211;293;600
00-7-02-05-6495;5;80;192;277;579
00-7-02-05-6496;7;75;184;266;579
00-7-02-05-6497;9;84;192;285;604
00-7-02-05-6498;5;85;202;292;604
00-7-02-05-6499;6;73;190;269;604
00-7-02-05-6500;5;101;179;285;604
00-7-02-05-6501;7;86;160;253;604
00-7-02-05-6502;4;92;193;289;606
00-7-02-05-6503;4;23;9;36;66
00-7-02-06-6504;7;47;83;137;432
00-7-02-06-6505;5;40;89;134;391
00-7-02-06-6506;6;44;80;130;391
00-7-02-06-6507;5;72;149;226;545
00-7-02-06-6508;1;17;28;46;97
00-7-02-07-6509;3;150;226;379;609
00-7-02-07-6510;5;150;238;393;609
00-7-02-07-6511;11;123;245;379;609
00-7-02-07-6512;7;108;239;354;609
00-7-02-07-6513;9;141;230;380;609
00-7-02-07-6514;11;152;209;372;610
00-7-02-07-6515;4;72;173;249;506
00-7-02-07-6516;13;64;159;236;506
00-7-02-07-6517;0;86;187;273;506
00-7-02-07-6518;12;87;163;262;506
00-7-02-07-6519;10;93;159;262;510
00-7-02-07-6520;10;104;137;251;451
00-7-02-07-6521;6;119;138;263;451
00-7-03-01-6522;10;108;169;287;570
00-7-03-01-6523;8;85;177;270;570
00-7-03-01-6524;3;99;150;252;570
00-7-03-01-6525;9;92;150;251;570
00-7-03-01-6526;8;129;160;297;570
00-7-03-01-6527;8;100;137;245;570
00-7-03-01-6528;12;113;138;263;570
00-7-03-01-6529;4;96;165;265;570
00-7-03-01-6530;9;104;149;262;570
00-7-03-01-6531;5;106;148;259;570
00-7-03-01-6532;6;118;146;270;570
00-7-03-01-6533;7;120;151;278;570
00-7-03-01-6534;10;103;138;251;570
00-7-03-01-6535;8;98;150;256;580
00-7-03-01-6536;2;46;63;111;377
00-7-03-01-6537;10;85;110;205;407
00-7-03-01-6538;6;80;117;203;407
00-7-03-01-6539;5;52;142;199;377
00-7-03-01-6540;7;50;146;203;378
00-7-03-01-6541;2;60;120;182;428
00-7-03-01-6542;5;59;89;153;429
00-7-03-01-6543;1;57;40;98;204
00-7-03-01-6544;1;31;65;97;253
00-7-03-01-6545;6;57;107;170;494
00-7-03-01-6546;9;52;115;176;494
00-7-03-01-6547;10;109;149;268;609
00-7-03-01-6548;6;101;182;289;609
00-7-03-01-6549;6;111;130;247;609
00-7-03-01-6550;10;110;151;271;609
00-7-03-01-6552;12;104;151;267;609
00-7-03-01-6553;7;127;153;287;609
00-7-03-01-6554;6;121;142;269;609
00-7-03-01-6555;6;123;153;282;609
00-7-03-01-6556;6;94;153;253;609
00-7-03-01-6557;4;95;159;258;609
00-7-03-01-6558;11;94;170;275;609
00-7-03-01-6559;5;99;148;252;609
00-7-03-01-6560;3;97;179;279;621
00-7-03-02-6561;2;59;74;135;370
00-7-03-02-6562;8;69;83;160;370
00-7-03-02-6563;28;132;147;307;625
00-7-03-02-6564;16;128;131;275;625
00-7-03-02-6565;8;92;146;246;627
00-7-03-02-6566;5;71;105;181;382
00-7-03-02-6567;5;51;96;152;382
00-7-03-02-6568;2;46;59;107;277
00-7-03-02-6569;1;54;78;133;309
00-7-03-02-6570;3;57;79;139;309
00-7-03-02-6571;5;53;79;137;466
00-7-03-02-6572;4;63;131;198;450
00-7-03-02-6573;4;11;28;43;127
00-7-03-03-6574;3;99;200;302;594
00-7-03-03-6575;5;112;215;332;595
00-7-03-03-6576;4;77;60;141;219
00-7-03-03-6577;2;23;30;55;83
00-7-03-03-6578;2;38;22;62;85
00-7-03-04-6579;6;93;129;228;552
00-7-03-04-6580;2;80;110;192;362
00-7-03-04-6581;5;106;94;205;363
00-7-03-04-6582;9;95;175;279;465
00-7-03-04-6583;9;81;163;253;465
00-7-03-05-6584;14;129;155;298;600
00-7-03-05-6585;5;111;172;288;600
00-7-03-05-6586;6;104;153;263;600
00-7-03-05-6587;10;118;184;312;600
00-7-03-05-6588;13;108;138;259;600
00-7-03-05-6589;12;106;148;266;557
00-7-03-05-6590;11;91;162;264;557
00-7-03-05-6591;2;20;48;70;186
00-7-03-05-6592;5;64;143;212;537
00-7-03-05-6593;0;12;31;43;85
00-7-03-06-6594;11;154;185;350;559
00-7-03-06-6595;8;144;204;356;559
00-7-03-06-6596;6;148;185;339;559
00-7-03-06-6597;9;90;180;279;541
00-7-03-06-6598;9;99;169;277;541
00-7-03-06-6599;7;85;163;255;541
00-7-03-06-6600;10;93;160;263;541
00-7-03-06-6601;10;111;151;272;464
00-7-03-07-6602;7;126;142;275;602
00-7-03-07-6603;6;107;145;258;602
00-7-03-07-6604;3;73;114;190;486
00-7-03-07-6605;0;45;95;140;487
00-7-03-07-6606;5;54;46;105;264
00-7-03-07-6607;3;98;115;216;467
00-7-03-07-6608;6;96;104;206;467
00-7-03-07-6609;0;27;36;63;185
00-7-04-01-6610;7;60;107;174;438
00-7-04-01-6611;6;83;152;241;603
00-7-04-01-6612;2;91;142;235;603
00-7-04-01-6613;2;68;131;201;603
00-7-04-01-6614;4;85;142;231;603
00-7-04-01-6615;3;94;164;261;603
00-7-04-01-6616;6;95;104;205;607
00-7-04-01-6617;7;108;91;206;576
00-7-04-01-6618;6;89;88;183;576
00-7-04-01-6619;7;81;94;182;576
00-7-04-01-6620;11;106;114;231;579
00-7-04-01-6621;5;100;81;186;358
00-7-04-01-6622;1;2;4;7;23
00-7-04-02-6623;3;62;92;157;536
00-7-04-02-6624;2;67;104;173;536
00-7-04-02-6625;5;72;81;158;537
00-7-04-02-6626;6;62;173;241;606
00-7-04-02-6627;8;70;174;252;606
00-7-04-02-6628;3;71;162;236;607
00-7-04-02-6629;3;68;44;115;227
00-7-04-02-6630;4;53;69;126;341
00-7-04-02-6631;7;52;68;127;342
00-7-04-02-6632;10;90;130;230;529
00-7-04-02-6633;9;117;120;246;529
00-7-04-03-6634;13;93;119;225;603
00-7-04-03-6635;10;113;97;220;604
00-7-04-03-6636;7;97;110;214;642
00-7-04-03-6637;14;98;114;226;642
00-7-04-03-6638;14;89;115;218;643
00-7-04-03-6639;8;63;73;144;392
00-7-04-03-6640;8;90;154;252;650
00-7-04-03-6641;7;80;132;219;650
00-7-04-03-6642;13;89;143;245;650
00-7-04-03-6643;11;83;151;245;650
00-7-04-03-6644;1;25;35;61;164
00-7-04-03-6645;7;46;107;160;336
00-7-04-03-6646;9;63;108;180;336
00-7-04-04-6647;10;119;92;221;527
00-7-04-04-6648;7;92;95;194;527
00-7-04-04-6649;7;111;93;211;527
00-7-04-04-6650;11;82;105;198;527
00-7-04-04-6651;5;53;110;168;404
00-7-04-04-6652;5;33;53;91;370
00-7-04-04-6653;6;51;63;120;370
00-7-04-04-6654;1;45;214;260;619
00-7-04-04-6655;7;40;207;254;619
00-7-04-04-6657;4;24;76;104;259
00-7-04-04-6658;1;18;9;28;275
00-7-05-01-6659;4;124;141;269;561
00-7-05-01-6660;3;130;140;273;561
00-7-05-01-6661;8;122;111;241;561
00-7-05-01-6662;4;113;141;258;563
00-7-05-01-6663;14;64;87;165;544
00-7-05-01-6664;4;90;153;247;481
00-7-05-01-6665;3;71;98;172;396
00-7-05-01-6666;13;74;148;235;511
00-7-05-01-6667;4;71;123;198;511
00-7-05-01-6668;1;74;65;140;307
00-7-05-01-6669;1;35;133;169;342
00-7-05-01-6670;4;49;88;141;296
00-7-05-02-6671;9;94;150;253;608
00-7-05-02-6672;4;107;180;291;608
00-7-05-02-6673;5;86;166;257;608
00-7-05-02-6674;4;98;176;278;608
00-7-05-02-6675;11;110;144;265;608
00-7-05-02-6676;5;101;166;272;608
00-7-05-02-6677;14;94;161;269;608
00-7-05-02-6678;5;103;149;257;608
00-7-05-02-6679;5;122;163;290;608
00-7-05-02-6680;11;108;130;249;608
00-7-05-02-6681;7;125;156;288;608
00-7-05-02-6682;11;103;152;266;608
00-7-05-02-6683;4;117;169;290;620
00-7-05-02-6684;1;72;73;146;406
00-7-05-02-6685;5;75;95;175;407
00-7-05-02-6686;6;129;97;232;518
00-7-05-02-6687;7;119;104;230;519
00-7-05-02-6688;6;80;77;163;349
00-7-05-02-6689;0;68;77;145;350
00-7-05-02-6690;4;92;107;203;449
00-7-05-02-6691;8;77;112;197;449
00-7-05-02-6692;6;57;114;177;354
00-7-05-02-6693;7;62;110;179;406
00-7-05-03-6694;6;93;113;212;477
00-7-05-03-6695;9;90;123;222;477
00-7-05-03-6696;18;78;122;218;477
00-7-05-03-6697;9;94;170;273;604
00-7-05-03-6698;8;87;168;263;605
00-7-05-03-6699;6;117;125;248;600
00-7-05-03-6700;10;99;143;252;600
00-7-05-03-6701;8;107;108;223;600
00-7-05-03-6702;8;102;152;262;575
00-7-05-03-6703;4;82;126;212;575
00-7-05-03-6704;4;91;70;165;340
00-7-05-03-6705;9;78;80;167;341
00-7-06-01-6706;7;76;189;272;626
00-7-06-01-6707;6;87;183;276;626
00-7-06-01-6708;6;82;188;276;626
00-7-06-01-6709;5;82;187;274;626
00-7-06-01-6710;6;110;178;294;626
00-7-06-01-6711;4;97;153;254;626
00-7-06-01-6712;8;108;163;279;626
00-7-06-01-6713;4;84;176;264;626
00-7-06-01-6714;2;82;208;292;626
00-7-06-01-6715;12;75;170;257;626
00-7-06-01-6716;3;92;190;285;626
00-7-06-01-6717;6;82;188;276;626
00-7-06-01-6718;5;93;142;240;626
00-7-06-01-6719;3;89;165;257;626
00-7-06-01-6720;8;97;164;269;626
00-7-06-01-6721;5;83;177;265;626
00-7-06-01-6722;5;106;176;287;639
00-7-06-01-6723;3;74;148;225;430
00-7-06-01-6724;5;86;140;231;431
00-7-06-01-6725;4;88;112;204;464
00-7-06-01-6726;2;105;91;198;465
00-7-06-01-6727;4;90;216;310;542
00-7-06-01-6728;3;76;190;269;554
00-7-06-01-6729;7;71;197;275;555
00-7-06-01-6730;3;43;31;77;163
00-7-06-01-6731;0;9;3;12;26
00-7-06-02-6732;5;117;153;275;457
00-7-06-02-6733;6;102;138;246;458
00-7-06-03-6734;4;109;163;276;510
00-7-06-03-6735;5;94;166;265;510
00-7-06-03-6736;7;94;165;266;510
00-7-06-03-6737;6;69;149;224;510
00-7-06-03-6738;12;78;171;261;511
00-7-06-03-6739;1;17;10;28;47
00-7-06-03-6740;17;82;175;274;587
00-7-06-03-6741;6;74;173;253;587
00-7-06-03-6742;12;104;178;294;587
00-7-06-03-6743;7;65;93;165;326
00-7-06-03-6744;3;63;102;168;327
00-7-06-04-6745;7;95;171;273;585
00-7-06-04-6746;5;93;171;269;585
00-7-06-04-6747;7;118;171;296;585
00-7-06-04-6748;8;88;170;266;585
00-7-06-04-6749;6;99;164;269;585
00-7-06-04-6750;9;106;153;268;585
00-7-06-04-6751;6;81;178;265;585
00-7-06-04-6752;9;110;166;285;585
00-7-06-04-6753;6;80;175;261;591
00-7-06-04-6754;5;79;126;210;558
00-7-06-04-6755;5;69;184;258;559
00-7-06-04-6756;8;91;72;171;325
00-7-06-04-6757;4;68;74;146;325
00-7-06-05-6758;2;64;132;198;466
00-7-06-05-6759;1;74;140;215;466
00-7-06-05-6760;4;75;119;198;466
00-7-06-05-6761;4;73;126;203;466
00-7-06-05-6762;2;65;111;178;358
00-7-06-05-6763;2;68;133;203;359
00-7-06-05-6764;5;64;155;224;464
00-7-06-05-6765;4;63;150;217;464
00-7-06-05-6766;6;84;125;215;464
00-7-06-05-6767;4;79;161;244;467
08-1-01-00-6768;16;147;47;210;973
08-10-01-00-6778;2;57;18;77;929
08-11-01-00-6779;0;11;11;22;56
08-12-01-00-6780;0;6;1;7;44
08-13-01-00-6781;0;21;11;32;198
08-14-01-00-6782;0;28;31;59;1228
08-14-01-00-6783;1;22;32;55;1228
08-14-01-00-6784;0;26;30;56;1230
08-14-02-00-6785;1;38;50;89;920
08-14-02-00-6786;0;40;41;81;920
08-14-02-00-6787;0;34;39;73;922
08-14-03-00-6788;0;29;20;49;1046
08-14-03-00-6789;0;19;16;35;1046
08-14-03-00-6790;0;36;19;55;1046
08-14-03-00-6791;0;31;17;48;1046
08-14-03-00-6792;0;26;20;46;1048
08-14-04-00-6793;0;42;39;81;1107
08-14-04-00-6794;1;50;39;90;1107
08-14-04-00-6795;0;46;41;87;1107
08-14-04-00-6796;3;57;32;92;1107
08-14-04-00-6797;2;42;54;98;1108
08-14-05-00-6798;1;40;56;97;1185
08-14-05-00-6799;1;31;58;90;1185
08-14-05-00-6800;2;41;62;105;1185
08-14-05-00-6801;0;37;46;83;1185
08-14-05-00-6802;1;30;61;92;1185
08-14-05-00-6803;2;32;31;65;1185
08-14-05-00-6805;1;32;54;87;1185
08-14-05-00-6806;0;36;50;86;1185
08-14-05-00-6807;0;40;62;102;1185
08-14-05-00-6808;0;29;58;87;1185
08-14-05-00-6809;1;48;44;93;1195
08-14-06-00-6810;4;66;30;100;881
08-14-06-00-6811;0;41;22;63;881
08-14-06-00-6812;4;49;26;79;881
08-14-07-00-6813;1;48;32;81;714
08-14-07-00-6814;0;38;15;53;714
08-15-01-00-6815;4;41;24;69;381
08-16-01-00-6816;5;92;33;130;725
08-16-01-00-6817;4;93;23;120;725
08-17-01-00-6818;17;110;38;165;569
08-18-01-00-6819;1;91;83;175;605
08-19-01-00-6820;2;46;21;69;310
08-2-01-00-6769;6;24;11;41;269
08-20-01-00-6821;0;20;8;28;159
08-21-01-00-6822;2;39;13;54;429
08-22-01-00-6823;3;15;11;29;119
08-23-01-00-6824;3;64;28;95;640
08-23-01-00-6825;2;89;40;131;641
08-24-01-00-6826;0;26;16;42;171
08-24-02-00-6827;1;84;37;122;1164
08-26-01-00-6828;6;72;45;123;392
08-27-01-00-6829;5;165;95;265;1051
08-27-02-00-6830;1;20;14;35;301
08-28-01-00-6831;1;33;20;54;239
08-29-01-00-6832;5;122;29;156;565
08-3-01-00-6770;4;40;10;54;191
08-30-01-00-6833;1;27;13;41;169
08-32-01-00-6835;0;10;1;11;49
08-33-01-00-6836;6;89;37;132;490
08-35-01-00-6837;0;7;5;12;31
08-37-01-00-6838;0;2;0;2;12
08-38-01-00-6839;0;17;5;22;47
08-39-01-00-6840;0;4;4;8;47
08-4-01-00-6771;2;43;14;59;218
08-40-01-00-6841;2;3;2;7;38
08-41-02-00-6842;0;7;10;17;147
08-43-01-00-6843;0;8;0;8;16
08-44-01-00-6844;0;3;0;3;8
08-45-01-00-6845;1;6;5;12;46
08-46-01-00-6846;0;0;2;2;6
08-48-01-00-6847;0;6;2;8;8
08-6-01-00-6772;0;16;3;19;120
08-7-01-00-6773;2;25;35;62;632
08-7-02-00-6774;3;56;82;141;875
08-8-01-00-6775;3;46;26;75;301
08-9-01-00-6776;1;7;1;9;109
